id	id
regNum	regNum
publishDate	publish_date
printFormurl	Печатная_форма_контракта
currentContractStage	Текущее_состояние_контракта
number	Номер_контракта
versionNumber	Номер_изменения
attachmentsattachmentdocDescription	Прикрепленный_документ_Описание
attachmentsattachmentfileName	Прикрепленный_документ_Название
attachmentsattachmenturl	Прикрепленный_документ_Ссылка
contractSubject	Предмет_контракта
customercustomerAccountsDetailscustomerAccountDetailsaccountType	Реквизиты_счета_заказчика_Тип_счета
customercustomerAccountsDetailscustomerAccountDetailsbankAccountNumber	Реквизиты_счета_заказчика_Номер_счета
customercustomerAccountsDetailscustomerAccountDetailsbik	Реквизиты_счета_заказчика_БИК_банка
customercustomerAccountsDetailscustomerAccountDetailscorrAccountNumber	Реквизиты_счета_заказчика_Корр_счет
customercustomerAccountsDetailscustomerAccountDetailscreditOrgName	Реквизиты_счета_заказчика_Наименование_банка
customerfullName	Заказчик_Полное_наименование
customerinn	Заказчик_ИНН
customerkpp	Заказчик_КПП
customerregistrationDate	Заказчик_Дата_постановки_на_учет
customershortName	Заказчик_Сокращенное_наименование
deliveryPlaceInfobyKLADRInfoKLADRInfofullName	Место_поставки_Название
deliveryPlaceInfobyKLADRInfodeliveryPlace	Место_поставки_Адрес
documentBase	Реквизиты_документа_подтверждающего_основание_заключения_контракта
executionPeriodendDate	Дата_окончания_исполнения_контракта
executionPeriodstagesendDate	Дата_окончания_исполнения_этапа
executionPeriodstagesstageAdvancePaymentSumpriceValue	Размер_аванса_по_этапу_контракта_в_валюте_контракта
executionPeriodstagesstageAdvancePaymentSumpriceValueRUR	Размер_аванса_по_этапу_контракта_в_российских_рублях
executionPeriodstagesstageAdvancePaymentSumsumInPercents	Процент_аванса_по_этапу_контракта
executionPeriodstagesstagePrice	Цена_этапа_контракта_в_валюте_контракта
executionPeriodstagesstagePriceRUR	Цена_этапа_контракта_в_российских_рублях
executionPeriodstagesstartDate	Дата_начала_исполнения_этапа
executionPeriodstartDate	Дата_начала_исполнения_контракта
executionsexecutionKTRUname	Информация_об_исполнении_Имя_по_КТРУ
executionsexecutionMNNInfoMNNName	Информация_об_исполнении_Предмет_контракта_наименование_лекарственного_препаратов
executionsexecutionOKEIfullName	Информация_об_исполнении_Единица_измерения
executionsexecutionOKPD2name	Информация_об_исполнении_Классификация_по_ОКПД2
executionsexecutionattachmentdocDescription	Информация_об_исполнении_Прикрепленный_документ_Описание
executionsexecutionattachmentfileName	Информация_об_исполнении_Прикрепленный_документ_Название
executionsexecutionattachmenturl	Информация_об_исполнении_Прикрепленный_документ_Ссылка
executionsexecutioncurrencyname	Информация_об_исполнении_Валюта
executionsexecutiondocAcceptancedeliveryAcceptDate	Информация_об_исполнении_Документ_о_приемке_Дата_подписания_заказчиком
executionsexecutiondocAcceptancedocumentDate	Информация_об_исполнении_Документ_о_приемке_Дата
executionsexecutiondocAcceptancedocumentNum	Информация_об_исполнении_Документ_о_приемке_Номер
executionsexecutiondocAcceptancefulfilmentSumRUR	Информация_об_исполнении_Документ_о_приемке_Стоимость_исполненных_обязательств
executionsexecutiondocAcceptancename	Информация_об_исполнении_Документ_о_приемке_Название
executionsexecutiondocAcceptancereceiptDocumentsattachmentdocDescription	Информация_об_исполнении_Документ_подтверждающий_приемку_товара_Описание
executionsexecutiondocAcceptancereceiptDocumentsattachmentfileName	Информация_об_исполнении_Документ_подтверждающий_приемку_товара_Название
executionsexecutiondocAcceptancereceiptDocumentsattachmenturl	Информация_об_исполнении_Документ_подтверждающий_приемку_товара_Ссылка
executionsexecutiondocExecutiondocumentDate	Информация_об_исполнении_Документ_об_исполнении_контракта_Дата
executionsexecutiondocExecutiondocumentNum	Информация_об_исполнении_Документ_об_исполнении_контракта_Номер
executionsexecutiondocExecutionname	Информация_об_исполнении_Документ_об_исполнении_контракта_Название
executionsexecutionpaid	Информация_об_исполнении_Фактически_оплачено_в_валюте_платежа
executionsexecutionpaidRUR	Информация_об_исполнении_Фактически_оплачено_в_рублевом_эквиваленте
executionsexecutionpaidVAT	Информация_об_исполнении_Значение_НДС_фактически_оплаченной_суммы_в_валюте_платежа
executionsexecutionpaidVATRUR	Информация_об_исполнении_Значение_НДС_фактически_оплаченной_суммы_в_рублевом_эквиваленте
executionsexecutionpayDocdocumentDate	Информация_об_исполнении_Платежный_документ_Дата
executionsexecutionpayDocdocumentName	Информация_об_исполнении_Платежный_документ_Название
executionsexecutionpayDocdocumentNum	Информация_об_исполнении_Платежный_документ_Номер
executionsexecutionproductVATRate	Информация_об_исполнении_Объект_закупки_Ставка_НДС
executionsexecutionproductname	Информация_об_исполнении_Объект_закупки_Название
executionsexecutionproductquantity	Информация_об_исполнении_Объект_закупки_Кол-во
executionsexecutionproducttype	Информация_об_исполнении_Объект_закупки_Тип
executionsexecutionquantityContractSubjectfulfilledCost	Информация_об_исполнении_Инфо_об_объекте_закупки_Стоимость
executionsexecutionquantityContractSubjectindexNum	Информация_об_исполнении_Инфо_об_объекте_закупки_Порядковый_номер
executionsexecutionquantityContractSubjectnomenclature	Информация_об_исполнении_Инфо_об_объекте_закупки_Описание
executionsexecutionquantityContractSubjectquantity	Информация_об_исполнении_Инфо_об_объекте_закупки_Кол-во
executionsexecutionquantityContractSubjectsquantityContractSubjectKTRUname	Информация_об_исполнении_Инфо_об_объекте_закупки_Название_по_КТРУ
executionsexecutionquantityContractSubjectsquantityContractSubjectOKEIfullName	Информация_об_исполнении_Инфо_об_объекте_закупки_Единица_измерения
executionsexecutionquantityContractSubjectsquantityContractSubjectOKPD2name	Информация_об_исполнении_Инфо_об_объекте_закупки_Название_по_ОКПД2
executionsexecutionquantityContractSubjectsquantityContractSubjectfulfilledCost	Информация_об_исполнении_Инфо_об_объекте_закупки_Стоимость
executionsexecutionquantityContractSubjectsquantityContractSubjectindexNum	Информация_об_исполнении_Инфо_об_объекте_закупки_Порядковый_номер
executionsexecutionquantityContractSubjectsquantityContractSubjectproductKTRUname	Информация_об_исполнении_Инфо_об_объекте_закупки_Название_по_КТРУ
executionsexecutionquantityContractSubjectsquantityContractSubjectproductOKEIfullName	Информация_об_исполнении_Инфо_об_объекте_закупки_Единица_измерения
executionsexecutionquantityContractSubjectsquantityContractSubjectproductOKPD2name	Информация_об_исполнении_Инфо_об_объекте_закупки_Название_по_ОКПД2
executionsexecutionquantityContractSubjectsquantityContractSubjectproductVATRate	Информация_об_исполнении_Инфо_об_объекте_закупки_Ставка_НДС
executionsexecutionquantityContractSubjectsquantityContractSubjectproducthierarchyType	Информация_об_исполнении_Инфо_об_объекте_закупки_Тип_объекта_закупки_в_иерархии
executionsexecutionquantityContractSubjectsquantityContractSubjectproductname	Информация_об_исполнении_Инфо_об_объекте_закупки_Название
executionsexecutionquantityContractSubjectsquantityContractSubjectproductpreviouslySuppliedQuantity	Информация_об_исполнении_Инфо_об_объекте_закупки_Объем_ранее_поставленного
executionsexecutionquantityContractSubjectsquantityContractSubjectproducttype	Информация_об_исполнении_Инфо_об_объекте_закупки_Тип
executionsexecutionquantityContractSubjectsquantityContractSubjectquantity	Информация_об_исполнении_Инфо_об_объекте_закупки_Кол-во
executionsexecutionquantityContractSubjectsquantityContractSubjectunitPrice	Информация_об_исполнении_Инфо_об_объекте_закупки_Цена
executionsexecutionquantityContractSubjectunitPrice	Информация_об_исполнении_Инфо_об_объекте_закупки_Цена
executionsexecutionquantityDrugContractSubjectVATRUR	Информация_об_исполнении_Инфо_об_объекте_медицинской_закупки_НДС
executionsexecutionquantityDrugContractSubjectVATRate	Информация_об_исполнении_Инфо_об_объекте_медицинской_закупки_Ставка_НДС
executionsexecutionquantityDrugContractSubjectconsumerPackagesQuantity	Информация_об_исполнении_Инфо_об_объекте_медицинской_закупки_Кол-во_упаковок
executionsexecutionquantityDrugContractSubjectdrugSeries	Информация_об_исполнении_Инфо_об_объекте_медицинской_закупки_Серия
executionsexecutionquantityDrugContractSubjectexpirationDate	Информация_об_исполнении_Инфо_об_объекте_медицинской_закупки_Срок_годности
executionsexecutionquantityDrugContractSubjectfulfilmentCostRUR	Информация_об_исполнении_Инфо_об_объекте_медицинской_закупки_Стоимость
executionsexecutionquantityDrugContractSubjectisZNVLP	Информация_об_исполнении_Инфо_об_объекте_медицинской_закупки_Стоимость_ЖНВЛП
executionsexecutionquantityDrugContractSubjectpackagePrice	Информация_об_исполнении_Инфо_об_объекте_медицинской_закупки_Цена_упаковки
executionsexecutionquantityDrugContractSubjectsquantityDrugContractSubjectMNNInfoMNNName	Информация_об_исполнении_Инфо_об_объекте_медицинской_закупки_Наименование_МНН
executionsexecutionquantityDrugContractSubjectsquantityDrugContractSubjectOKEIfullName	Информация_об_исполнении_Инфо_об_объекте_медицинской_закупки_Единица_измерения
executionsexecutionquantityDrugContractSubjectsquantityDrugContractSubjectOKPD2name	Информация_об_исполнении_Инфо_об_объекте_медицинской_закупки_Название_по_ОКПД2
executionsexecutionquantityDrugContractSubjectsquantityDrugContractSubjectVATRUR	Информация_об_исполнении_Инфо_об_объекте_медицинской_закупки_НДС
executionsexecutionquantityDrugContractSubjectsquantityDrugContractSubjectVATRate	Информация_об_исполнении_Инфо_об_объекте_медицинской_закупки_Ставка_НДС
executionsexecutionquantityDrugContractSubjectsquantityDrugContractSubjectconsumerPackagesQuantity	Информация_об_исполнении_Инфо_об_объекте_медицинской_закупки_Кол-во_упаковок
executionsexecutionquantityDrugContractSubjectsquantityDrugContractSubjectdrugProductInfodrugInfoUsingTextFormMNNName	Информация_об_исполнении_Инфо_об_объекте_медицинской_закупки_Наименование_МНН
executionsexecutionquantityDrugContractSubjectsquantityDrugContractSubjectdrugProductInfodrugInfoUsingTextFormtradeName	Информация_об_исполнении_Инфо_об_объекте_медицинской_закупки_Торговое_название
executionsexecutionquantityDrugContractSubjectsquantityDrugContractSubjectdrugSeries	Информация_об_исполнении_Инфо_об_объекте_медицинской_закупки_Серия
executionsexecutionquantityDrugContractSubjectsquantityDrugContractSubjectexpirationDate	Информация_об_исполнении_Инфо_об_объекте_медицинской_закупки_Срок_годности
executionsexecutionquantityDrugContractSubjectsquantityDrugContractSubjectfulfilmentCostRUR	Информация_об_исполнении_Инфо_об_объекте_медицинской_закупки_Стоимость
executionsexecutionquantityDrugContractSubjectsquantityDrugContractSubjectisZNVLP	Информация_об_исполнении_Инфо_об_объекте_медицинской_закупки_Стоимость_ЖНВЛП
executionsexecutionquantityDrugContractSubjectsquantityDrugContractSubjectpackagePrice	Информация_об_исполнении_Инфо_об_объекте_медицинской_закупки_Цена_упаковки
executionsexecutionquantityDrugContractSubjectsquantityDrugContractSubjectproductMNNsInfoMNNInfoMNNName	Информация_об_исполнении_Инфо_об_объекте_медицинской_закупки_Наименование_МНН
executionsexecutionquantityDrugContractSubjectsquantityDrugContractSubjectproductOKEIfullName	Информация_об_исполнении_Инфо_об_объекте_медицинской_закупки_Единица_измерения
executionsexecutionquantityDrugContractSubjectsquantityDrugContractSubjectproductOKPD2name	Информация_об_исполнении_Инфо_об_объекте_медицинской_закупки_Название_по_ОКПД2
executionsexecutionquantityDrugContractSubjectsquantityDrugContractSubjectproductname	Информация_об_исполнении_Инфо_об_объекте_медицинской_закупки_Название
executionsexecutionquantityDrugContractSubjectsquantityDrugContractSubjectproductquantity	Информация_об_исполнении_Инфо_об_объекте_медицинской_закупки_Кол-во
executionsexecutionquantityDrugContractSubjectsquantityDrugContractSubjectproducttype	Информация_об_исполнении_Инфо_об_объекте_медицинской_закупки_Тип
executionsexecutionquantityDrugContractSubjectsquantityDrugContractSubjecttradeInfotradeName	Информация_об_исполнении_Инфо_об_объекте_медицинской_закупки_Торговое_название
executionsexecutionquantityDrugContractSubjectsumaryDrugQuantity	Информация_об_исполнении_Инфо_об_объекте_медицинской_закупки_Кол-во_поставленного
executionsexecutionreceiptDocumentsattachmentdocDescription	Информация_об_исполнении_Документы_подтверждающие_приемку_товара_Описание
executionsexecutionreceiptDocumentsattachmentfileName	Информация_об_исполнении_Документы_подтверждающие_приемку_товара_Название
executionsexecutionreceiptDocumentsattachmenturl	Информация_об_исполнении_Документы_подтверждающие_приемку_товара_Ссылка
executionsexecutiontradeInfotradeName	Информация_об_исполнении_Инфо_об_объекте_медицинской_закупки_Торговое_название
executionsordinalNumber	Информация_об_исполнении_Номер_исполнения_в_рамках_этапа
executionsstageendDate	Информация_об_исполнении_Дата_окончания_исполнения_этапа
foundationfcsOrderordercontractProjectNumber	Основание_заключения_контракта_Закупка_Реестровый_номер
foundationfcsOrderorderlotNumber	Основание_заключения_контракта_Закупка_Порядковый_номер_лота
foundationfcsOrderordernotificationNumber	Основание_заключения_контракта_Закупка_Номер_извещения_о_проведении
foundationfcsOrderorderplacing	Основание_заключения_контракта_Закупка_Способ_определения_поставщиков
foundationfcsOrderordersingleCustomerattachmentsattachmentdocDescription	Основание_заключения_контракта_Закупка_у_одного_поставщика_Вложение_Описание
foundationfcsOrderordersingleCustomerattachmentsattachmentfileName	Основание_заключения_контракта_Закупка_у_одного_поставщика_Вложение_Название
foundationfcsOrderordersingleCustomerattachmentsattachmenturl	Основание_заключения_контракта_Закупка_у_одного_поставщика_Вложение_Ссылка
foundationfcsOrderordersingleCustomerdocumentname	Основание_заключения_контракта_Закупка_у_одного_поставщика_Документ
foundationfcsOrderordersingleCustomerreasonname	Основание_заключения_контракта_Закупка_у_одного_поставщика_Причина
foundationfcsOrdersingleCustomerattachmentsattachmentdocDescription	Основание_заключения_контракта_Закупка_у_единственного_поставщика_Вложение_Описание
foundationfcsOrdersingleCustomerattachmentsattachmentfileName	Основание_заключения_контракта_Закупка_у_единственного_поставщика_Вложение_Название
foundationfcsOrdersingleCustomerattachmentsattachmenturl	Основание_заключения_контракта_Закупка_у_единственного_поставщика_Вложение_Ссылка
foundationfcsOrdersingleCustomerdocumentname	Основание_заключения_контракта_Закупка_у_единственного_поставщика_Документ
foundationfcsOrdersingleCustomerreasonname	Основание_заключения_контракта_Закупка_у_единственного_поставщика_Причина
href	Гиперссылка_на_опубликованные_сведения_о_контракте
paymentDocumentsattachmentdocDescription	Документы_подтверждающие_исполнение_оплату_Вложение_Описание
paymentDocumentsattachmentfileName	Документы_подтверждающие_исполнение_оплату_Вложение_Название
paymentDocumentsattachmenturl	Документы_подтверждающие_исполнение_оплату_Вложение_Ссылка
penaltiespenaltyAccrualaccrualAmount	Информация_о_неустойках_Начисление_неустойки_Размер
penaltiespenaltyAccrualcontractParty	Информация_о_неустойках_Начисление_неустойки_Сторона_контракта
penaltiespenaltyAccrualcurrencyname	Информация_о_неустойках_Начисление_неустойки_Валюта
penaltiespenaltyAccrualpaymentspaymentamount	Информация_о_неустойках_Начисление_неустойки_Оплата_Сумма_в_валюте
penaltiespenaltyAccrualpaymentspaymentamountRUR	Информация_о_неустойках_Начисление_неустойки_Оплата_Сумма_в_рублях
penaltiespenaltyAccrualpaymentspaymentdocumentDate	Информация_о_неустойках_Начисление_неустойки_Докуент_об_оплате_Дата
penaltiespenaltyAccrualpaymentspaymentdocumentName	Информация_о_неустойках_Начисление_неустойки_Докуент_об_оплате_Название
penaltiespenaltyAccrualpaymentspaymentdocumentNum	Информация_о_неустойках_Начисление_неустойки_Докуент_об_оплате_Номер
penaltiespenaltyAccrualpaymentstotalAmount	Информация_о_неустойках_Начисление_неустойки_Итого_оплачено
penaltiespenaltyAccrualpenaltyDocumentdocumentDate	Информация_о_неустойках_Начисление_неустойки_Требование_заказчика_Дата
penaltiespenaltyAccrualpenaltyDocumentdocumentName	Информация_о_неустойках_Начисление_неустойки_Требование_заказчика_Название
penaltiespenaltyAccrualpenaltyDocumentdocumentNum	Информация_о_неустойках_Начисление_неустойки_Требование_заказчика_Номер
penaltiespenaltyAccrualpenaltyReasonname	Информация_о_неустойках_Начисление_неустойки_Причина
penaltiespenaltyAccrualpenaltyType	Информация_о_неустойках_Начисление_неустойки_Тип_взыскания
placementDate	Дата_первоначального_размещения_документа
placerresponsibleOrgfullName	Организация_разместившая_контракт
placerresponsibleRole	Роль_организации_разместившей_контракт
priceInfocurrencyname	Информация_о_цене_контракта_Валюта
priceInfoprice	Информация_о_цене_контракта_Цена_в_валюте_контракта
priceInfopriceRUR	Информация_о_цене_контракта_Цена_контракта_в_рублевом_эквиваленте
priceInfopriceVAT	Информация_о_цене_контракта_Значение_НДС_в_валюте_контракта
priceInfopriceVATRUR	Информация_о_цене_контракта_Значение_НДС_в_рублевом_эквиваленте
productsproductKTRUcharacteristicscharacteristicsUsingReferenceInfoname	Объекты_закупки_Характеристика_позиции
productsproductKTRUcharacteristicscharacteristicsUsingReferenceInfovalueRangemax	Объекты_закупки_Характеристика_позиции_Максимальное_значение
productsproductKTRUcharacteristicscharacteristicsUsingReferenceInfovalueRangemin	Объекты_закупки_Характеристика_позиции_Минимальное_значение
productsproductKTRUcharacteristicscharacteristicsUsingReferenceInfovalueSetconcreteValue	Объекты_закупки_Характеристика_позиции_Значение
productsproductKTRUcharacteristicscharacteristicsUsingReferenceInfovaluequalityDescription	Объекты_закупки_Характеристика_позиции_Описание
productsproductKTRUcharacteristicscharacteristicsUsingReferenceInfovaluesvaluequalityDescription	Объекты_закупки_Характеристика_позиции_Описание
productsproductKTRUcharacteristicscharacteristicsUsingReferenceInfovaluesvaluerangeSetvalueRangemax	Объекты_закупки_Характеристика_позиции_Максимальное_значение
productsproductKTRUcharacteristicscharacteristicsUsingReferenceInfovaluesvaluerangeSetvalueRangemin	Объекты_закупки_Характеристика_позиции_Минимальное_значение
productsproductKTRUcharacteristicscharacteristicsUsingTextFormname	Объекты_закупки_Характеристика_позиции
productsproductKTRUcharacteristicscharacteristicsUsingTextFormvalueSetconcreteValue	Объекты_закупки_Характеристика_позиции_Значение
productsproductKTRUcharacteristicscharacteristicsUsingTextFormvaluequalityDescription	Объекты_закупки_Характеристика_позиции_Описание
productsproductKTRUname	Объекты_закупки_Классификация_по_КТРУ
productsproductMNNInfoMNNName	Объекты_закупки_Наименование_лекарственного_препарата
productsproductOKEIfullName	Объекты_закупки_Единица_измерения
productsproductOKPD2name	Объекты_закупки_Классификация_по_ОКПД2
productsproductVATRate	Объекты_закупки_Ставка_НДС
productsproductcharacteristicscharacteristicsUsingReferenceInfoname	Объекты_закупки_Характеристика_позиции
productsproductcharacteristicscharacteristicsUsingReferenceInfovalueRangemax	Объекты_закупки_Характеристика_позиции_Максимальное_значение
productsproductcharacteristicscharacteristicsUsingReferenceInfovalueRangemin	Объекты_закупки_Характеристика_позиции_Минимальное_значение
productsproductcharacteristicscharacteristicsUsingReferenceInfovalueSetconcreteValue	Объекты_закупки_Характеристика_позиции_Значение
productsproductcharacteristicscharacteristicsUsingReferenceInfovaluequalityDescription	Объекты_закупки_Характеристика_позиции_Описание
productsproductcharacteristicscharacteristicsUsingReferenceInfovaluesvaluequalityDescription	Объекты_закупки_Характеристика_позиции_Описание
productsproductcharacteristicscharacteristicsUsingTextFormname	Объекты_закупки_Характеристика_позиции
productsproductcharacteristicscharacteristicsUsingTextFormvalueRangemax	Объекты_закупки_Характеристика_позиции_Максимальное_значение
productsproductcharacteristicscharacteristicsUsingTextFormvalueRangemin	Объекты_закупки_Характеристика_позиции_Минимальное_значение
productsproductcharacteristicscharacteristicsUsingTextFormvaluequalityDescription	Объекты_закупки_Характеристика_позиции_Описание
productsproductdrugPurchaseObjectInfodrugInfoUsingReferenceInfoMNNsInfoMNNInfoMNNName	Объекты_закупки_Лекарственный_препарат_Наименование_МНН
productsproductdrugPurchaseObjectInfodrugInfoUsingReferenceInfoMNNsInfoMNNInfopositionsTradeNamepositionTradeNametradeInfotradeName	Объекты_закупки_Лекарственный_препарат_Торговое_наименование
productsproducthierarchyType	Объекты_закупки_Тип_объекта_закупки_в_иерархии
productsproductimprovedProductReplacement	Объекты_закупки_Поставляется_объект_закупки_с_улучшенными_характеристиками
productsproductindexNum	Объекты_закупки_Номер
productsproductmedicalProductInfomedicalProductName	Объекты_закупки_Медицинское_изделие_Наименование
productsproductname	Объекты_закупки_Название
productsproductpackagingInfocompleteness	Объекты_закупки_Комплектность_упаковки
productsproductprice	Объекты_закупки_Цена_в_валюте_контракта
productsproductpriceRUR	Объекты_закупки_Цена_в_рублевом_эквиваленте
productsproductquantity	Объекты_закупки_Кол-во
productsproductsum	Объекты_закупки_Стоимость_в_валюте_контракта
productsproductsumRUR	Объекты_закупки_Стоимость_в_рублевом_эквиваленте
productsproducttradeInfotradeName	Объекты_закупки_Торговое_наименование_препарата
productsproducttype	Объекты_закупки_Тип_объекта
productsproductvalueRangemax	Объекты_закупки_Характеристика_позиции_Максимальное_значение
productsproductvalueRangemin	Объекты_закупки_Характеристика_позиции_Минимальное_значение
productsproductvalueSetconcreteValue	Объекты_закупки_Характеристика_позиции_Значение
productsproductvaluequalityDescription	Объекты_закупки_Характеристика_позиции_Описание
productsproductvolumeSpecifyingMethod	Объекты_закупки_Характеристика_позиции_Значение
productsproductvolumeTextForm	Объекты_закупки_Характеристика_позиции_Значение
productsquantityUndefined	Объекты_закупки_Невозможно_указать_сведения_о_количестве
protocolDate	Дата_подведения_результатов_определения_поставщика
quantityContractStages	Количество_этапов_контракта
receiptDocumentsattachmentdocDescription	Документы_подтверждающие_приемку_товара_Описание
receiptDocumentsattachmentfileName	Документы_подтверждающие_приемку_товара_Название
receiptDocumentsattachmenturl	Документы_подтверждающие_приемку_товара_Ссылка
scanDocumentsattachmentdocDescription	Отсканированная_копия_контракта_Описание
scanDocumentsattachmentfileName	Отсканированная_копия_контракта_Название
scanDocumentsattachmenturl	Отсканированная_копия_контракта_Ссылка
signDate	Дата_заключения_контракта
suppliersInfosupplierInfoEGRULInfoINN	Информация_о_поставщиках_Сведения_из_ЕГРЮЛ_ИНН
suppliersInfosupplierInfoEGRULInfoKPP	Информация_о_поставщиках_Сведения_из_ЕГРЮЛ_КПП
suppliersInfosupplierInfoEGRULInfoOGRN	Информация_о_поставщиках_Сведения_из_ЕГРЮЛ_ОГРН
suppliersInfosupplierInfoEGRULInfoaddress	Информация_о_поставщиках_Сведения_из_ЕГРЮЛ_Адрес
suppliersInfosupplierInfoEGRULInfofirmName	Информация_о_поставщиках_Сведения_из_ЕГРЮЛ_Фирменное_наименование
suppliersInfosupplierInfoEGRULInfofullName	Информация_о_поставщиках_Сведения_из_ЕГРЮЛ_Полное_наименование
suppliersInfosupplierInfoEGRULInforegistrationDate	Информация_о_поставщиках_Сведения_из_ЕГРЮЛ_Дата_постановки_на_учет
suppliersInfosupplierInfoEGRULInfoshortName	Информация_о_поставщиках_Сведения_из_ЕГРЮЛ_Краткое_наименование
suppliersInfosupplierInfoOKTMOname	Информация_о_поставщиках_Код_территории_муниципального_образования
suppliersInfosupplierInfosupplierAccountsDetailssupplierAccountDetailsaccountType	Информация_о_поставщиках_Реквизиты_счета_поставщика_Тип_аккаунта
suppliersInfosupplierInfosupplierAccountsDetailssupplierAccountDetailsbankAccountNumber	Информация_о_поставщиках_Реквизиты_счета_поставщика_Номер_банковского_счета
suppliersInfosupplierInfosupplierAccountsDetailssupplierAccountDetailsbik	Информация_о_поставщиках_Реквизиты_счета_поставщика_БИК
suppliersInfosupplierInfosupplierAccountsDetailssupplierAccountDetailscorrAccountNumber	Информация_о_поставщиках_Реквизиты_счета_поставщика_Коррсчет
suppliersInfosupplierInfosupplierAccountsDetailssupplierAccountDetailscreditOrgName	Информация_о_поставщиках_Реквизиты_счета_поставщика_Наименование_кредитной_организации
supplierssupplierOKTMOname	Поставщики_Код_территории_муниципального_образования
terminationDocumentsattachmentdocDescription	Информация_о_расторжении_контракта_Вложение_Описание
terminationDocumentsattachmentfileName	Информация_о_расторжении_контракта_Вложение_Название
terminationDocumentsattachmenturl	Информация_о_расторжении_контракта_Вложение_Ссылка
terminationdecisionDate	Информация_о_расторжении_контракта_Дата_уведомления
terminationdocTerminationdocumentDate	Информация_о_расторжении_контракта_Основание_расторжения_контракта_Дата
terminationdocTerminationdocumentNum	Информация_о_расторжении_контракта_Основание_расторжения_контракта_Номер
terminationdocTerminationname	Информация_о_расторжении_контракта_Основание_расторжения_контракта_Название
terminationpaid	Информация_о_расторжении_контракта_Фактически_оплачено
terminationreasonInfo	Информация_о_расторжении_контракта_Причина_расторжения_контракта
terminationreasonname	Информация_о_расторжении_контракта_Основание_расторжения_контракта
terminationterminationDate	Информация_о_расторжении_контракта_Дата_расторжения_контракта