id	id
regNum	regNum
delayWriteOffPenaltiesdelayPenaltiescurrencyname	Информация_о_предоставлении_отсрочки_Валюта
delayWriteOffPenaltiesdelayPenaltiesdelayAmount	Информация_о_предоставлении_отсрочки_Сумма_неустойки
delayWriteOffPenaltiesdelayPenaltiesdelayDate	Информация_о_предоставлении_отсрочки_Дата
delayWriteOffPenaltiesdelayPenaltiesnoticeDetailsdocumentDate	Информация_о_предоставлении_отсрочки_Дата_документа
delayWriteOffPenaltiesdelayPenaltiesnoticeDetailsdocumentNum	Информация_о_предоставлении_отсрочки_Номер_документа
delayWriteOffPenaltieswriteOffPenaltiescurrencyname	Информация_о_предоставлении_отсрочки_Валюта
delayWriteOffPenaltieswriteOffPenaltiesnoticeDetailsdocumentDate	Информация_о_предоставлении_отсрочки_Дата_документа_о_списании
delayWriteOffPenaltieswriteOffPenaltiesnoticeDetailsdocumentNum	Информация_о_предоставлении_отсрочки_Номер_документа_о_списании
delayWriteOffPenaltieswriteOffPenaltieswriteOffDate	Информация_о_предоставлении_отсрочки_Дата_списания_неустойки
medicalDocumentsattachmentdocDescription	Документы_решения_врачебной_комиссии_Вложение_Описание
medicalDocumentsattachmentfileName	Документы_решения_врачебной_комиссии_Вложение_Название
medicalDocumentsattachmenturl	Документы_решения_врачебной_комиссии_Вложение_Ссылка
refundOverpaymentsInfocurrencyname	Инфо_о_возврате_поставщиком_переплаты_по_контракту_Валюта
refundOverpaymentsInforefundOverpaidDocumentsattachmentdocDescription	Инфо_о_возврате_поставщиком_переплаты_по_контракту_Документ_основание_для_возврата_Описание
refundOverpaymentsInforefundOverpaidDocumentsattachmentfileName	Инфо_о_возврате_поставщиком_переплаты_по_контракту_Документ_основание_для_возврата_Название
refundOverpaymentsInforefundOverpaidDocumentsattachmenturl	Инфо_о_возврате_поставщиком_переплаты_по_контракту_Документ_основание_для_возврата_Ссылка
refundOverpaymentsInforefundOverpaymentInfoamountOverpaidsInfoamountOverpaidInfoamountOverpaidSum	Инфо_о_возврате_поставщиком_переплаты_по_контракту_Размер_излишне_уплаченной_суммы
refundOverpaymentsInforefundOverpaymentInfoamountOverpaidsInfoamountOverpaidInfooverpaidDate	Инфо_о_возврате_поставщиком_переплаты_по_контракту_Размер_излишне_уплаченной_суммы_Дата
refundOverpaymentsInforefundOverpaymentInfoamountRefundsInfoamountRefundInfoamountRefundSum	Инфо_о_возврате_поставщиком_переплаты_по_контракту_Размер_возвращенной_заказчику_переплаты
refundOverpaymentsInforefundOverpaymentInfoamountRefundsInfoamountRefundInforefundDate	Инфо_о_возврате_поставщиком_переплаты_по_контракту_Размер_возвращенной_заказчику_переплаты_Дата
refundOverpaymentsInforefundOverpaymentInfofoundationRefundDocsInfofoundationRefundDocInfodate	Инфо_о_возврате_поставщиком_переплаты_по_контракту_Основание_для_возврата_Дата
refundOverpaymentsInforefundOverpaymentInfofoundationRefundDocsInfofoundationRefundDocInfoname	Инфо_о_возврате_поставщиком_переплаты_по_контракту_Основание_для_возврата_Название
refundOverpaymentsInforefundOverpaymentInfofoundationRefundDocsInfofoundationRefundDocInfonumber	Инфо_о_возврате_поставщиком_переплаты_по_контракту_Основание_для_возврата_Номер
singleSupplierP25Part1St93DocumentsattachmentdocDescription	Документы_о_согласовании_контрольным_органом_заключения_контракта_с_единственным_поставщиком_Описание
singleSupplierP25Part1St93DocumentsattachmentfileName	Документы_о_согласовании_контрольным_органом_заключения_контракта_с_единственным_поставщиком_Название
singleSupplierP25Part1St93Documentsattachmenturl	Документы_о_согласовании_контрольным_органом_заключения_контракта_с_единственным_поставщиком_Ссылка
st14InfoNPAsInfoNPAInfoname	Информация_о_применении_к_закупке_национального_режима_Нормативно-правовой_акт_Название
st14InfoNPAsInfoNPAInfoshortName	Информация_о_применении_к_закупке_национального_режима_Нормативно-правовой_акт_Название_краткое
st14InfoNPAsInforequirementName	Информация_о_применении_к_закупке_национального_режима_Наименование_вида
st14InfoNPAsInforequirementType	Информация_о_применении_к_закупке_национального_режима_Вид_требования
subContractorsSumpriceValueRUR	Объем_привлечения_к_исполнению_контракта_субподрядчиков_В_рублевом_эквиваленте
subContractorsSumsumInPercents	Объем_привлечения_к_исполнению_контракта_субподрядчиков_В_процентах
examinationResultsDocumentsattachmentdocDescription	Документ_о_результатах_проведенной_экспертизы_поставленного_товара_выполненной_работы_оказанной_услуги_Описание
examinationResultsDocumentsattachmentfileName	Документ_о_результатах_проведенной_экспертизы_поставленного_товара_выполненной_работы_оказанной_услуги_Название
examinationResultsDocumentsattachmenturl	Документ_о_результатах_проведенной_экспертизы_поставленного_товара_выполненной_работы_оказанной_услуги_Ссылка
enforcementbankGuaranteecurrencyname	Обеспечение_исполнения_контракта_Валюта
enforcementbankGuaranteeguaranteeAmount	Обеспечение_исполнения_контракта_Сумма
enforcementcashAccountamount	Обеспечение_исполнения_контракта_Сумма
enforcementcashAccountcurrencyname	Обеспечение_исполнения_контракта_Валюта
financesbudgetFundsOKTMOname	Финансирование_Бюджетные_средства_Код_территории
financesbudgetFundsbudgetLevel	Финансирование_Бюджетные_средства_Уровень_бюджета
financesbudgetFundsbudgetname	Финансирование_Бюджетные_средства_Название
financesbudgetFundsfundsBudgetLevel	Финансирование_Бюджетные_средства_Уровень_бюджета_фонда
financesbudgetFundsstagesendDate	Финансирование_Бюджетные_средства_Дата_окончания_исполнения_этапа
financesbudgetFundsstagespaymentscomment	Финансирование_Бюджетные_средства_Платежи_по_этапу_Примечание
financesbudgetFundsstagespaymentspaymentMonth	Финансирование_Бюджетные_средства_Платежи_по_этапу_Месяц_платежа
financesbudgetFundsstagespaymentspaymentSum	Финансирование_Бюджетные_средства_Платежи_по_этапу_Сумма_платежа_в_валюте_контракта
financesbudgetFundsstagespaymentspaymentSumRUR	Финансирование_Бюджетные_средства_Платежи_по_этапу_Сумма_платежа_в_рублевом_эквиваленте
financesbudgetFundsstagespaymentspaymentYear	Финансирование_Бюджетные_средства_Платежи_по_этапу_Год_платежа
financesbudgetFundsstagesstartDate	Финансирование_Бюджетные_средства_Дата_начала_этапа
financesextrabudgetFundsextrabudgetname	Финансирование_Внебюджетные_средства_Название
financesextrabudgetFundsstagesendDate	Финансирование_Внебюджетные_средства_Дата_окончания_исполнения_этапа
financesextrabudgetFundsstagespaymentspaymentMonth	Финансирование_Внебюджетные_средства_Платежи_по_этапу_Месяц_платежа
financesextrabudgetFundsstagespaymentspaymentSum	Финансирование_Внебюджетные_средства_Платежи_по_этапу_Сумма_платежа_в_валюте_контракта
financesextrabudgetFundsstagespaymentspaymentSumRUR	Финансирование_Внебюджетные_средства_Платежи_по_этапу_Сумма_платежа_в_рублевом_эквиваленте
financesextrabudgetFundsstagespaymentspaymentYear	Финансирование_Внебюджетные_средства_Платежи_по_этапу_Год_платежа
financesextrabudgetFundsstagesstartDate	Финансирование_Внебюджетные_средства_Дата_начала_этапа
financesfinancingPlanfinanceSourcebudgetFundsOKTMOname	Финансирование_График_Бюджетные_средства_Код_территории
financesfinancingPlanfinanceSourcebudgetFundsbudgetname	Финансирование_График_Бюджетные_средства_Название
financesfinancingPlanfinanceSourcebudgetFundsfundsBudgetLevel	Финансирование_График_Бюджетные_средства_Уровень_бюджета_фонда
financesfinancingPlanfinanceSourceextrabudgetFundsextrabudgetname	Финансирование_График_Внебюджетные_средства_Название
financesfinancingPlanstagesendDate	Финансирование_График_Дата_окончания_исполнения_этапа
financesfinancingPlanstagespaymentscomment	Финансирование_График_Платежи_по_этапу_Примечание
financesfinancingPlanstagespaymentspaymentMonth	Финансирование_График_Платежи_по_этапу_Месяц_платежа
financesfinancingPlanstagespaymentspaymentSum	Финансирование_График_Платежи_по_этапу_Сумма_платежа_в_валюте_контракта
financesfinancingPlanstagespaymentspaymentSumRUR	Финансирование_График_Платежи_по_этапу_Сумма_платежа_в_рублевом_эквиваленте
financesfinancingPlanstagespaymentspaymentYear	Финансирование_График_Платежи_по_этапу_Год_платежа
financesfinancingPlanstagesstartDate	Финансирование_График_Дата_начала_этапа
modificationReason	Описание_внесения_изменений_Причина
modificationattachmentsattachmentdocDescription	Описание_внесения_изменений_Вложение_Описание
modificationattachmentsattachmentfileName	Описание_внесения_изменений_Вложение_Название
modificationattachmentsattachmenturl	Описание_внесения_изменений_Вложение_Ссылка
modificationcontractChangedocumentbase	Описание_внесения_изменений_Изменение_контракта_Документ_Реквизиты
modificationcontractChangedocumentdocumentDate	Описание_внесения_изменений_Изменение_контракта_Документ_Дата
modificationcontractChangedocumentname	Описание_внесения_изменений_Изменение_контракта_Документ_Название
modificationcontractChangereasonname	Описание_внесения_изменений_Изменение_контракта_Причина
modificationerrorCorrectiondescription	Описание_внесения_изменений_Корректировка_ошибок
okpd2okved2	Классификация_по_ОКПД2/ОКВЭД2
suppliersInfosupplierInfootherInfoOKPO	Информация_о_поставщиках_Прочее_ОКПО
suppliersInfosupplierInfootherInfocontactEMail	Информация_о_поставщиках_Прочее_EMAIL
suppliersInfosupplierInfootherInfocontactPhone	Информация_о_поставщиках_Прочее_Телефон
suppliersInfosupplierInfoindividualPersonForeignStatefirstName	Информация_о_поставщиках_Физлицо_иностранное_Имя
suppliersInfosupplierInfoindividualPersonForeignStatelastName	Информация_о_поставщиках_Физлицо_иностранное_Фамилия
suppliersInfosupplierInfoindividualPersonForeignStatemiddleName	Информация_о_поставщиках_Физлицо_иностранное_Отчество
suppliersInfosupplierInfoindividualPersonRFINN	Информация_о_поставщиках_Физлицо_РФ_ИНН
suppliersInfosupplierInfoindividualPersonRFIndEntrEGRIPInfoINN	Информация_о_поставщиках_Физлицо_РФ-ИП_ЕГРИП_ИНН
suppliersInfosupplierInfoindividualPersonRFIndEntrEGRIPInfoOGRNIP	Информация_о_поставщиках_Физлицо_РФ-ИП_ЕГРИП_ОГРНИП
suppliersInfosupplierInfoindividualPersonRFIndEntrEGRIPInfoaddress	Информация_о_поставщиках_Физлицо_РФ-ИП_ЕГРИП_Адрес_места_нахождения
suppliersInfosupplierInfoindividualPersonRFIndEntrEGRIPInfofirstName	Информация_о_поставщиках_Физлицо_РФ-ИП_ЕГРИП_Имя
suppliersInfosupplierInfoindividualPersonRFIndEntrEGRIPInfolastName	Информация_о_поставщиках_Физлицо_РФ-ИП_ЕГРИП_Фамилия
suppliersInfosupplierInfoindividualPersonRFIndEntrEGRIPInfomiddleName	Информация_о_поставщиках_Физлицо_РФ-ИП_ЕГРИП_Отчество
suppliersInfosupplierInfoindividualPersonRFIndEntrEGRIPInforegistrationDate	Информация_о_поставщиках_Физлицо_РФ-ИП_ЕГРИП_Дата_постановки_на_учет
suppliersInfosupplierInfoindividualPersonRFIndEntrotherInfoOKTMOname	Информация_о_поставщиках_Физлицо_РФ-ИП_Код_территории_муниципального_образования
suppliersInfosupplierInfoindividualPersonRFIndEntrotherInfocontactEMail	Информация_о_поставщиках_Физлицо_РФ-ИП_EMAIL
suppliersInfosupplierInfoindividualPersonRFIndEntrotherInfocontactPhone	Информация_о_поставщиках_Физлицо_РФ-ИП_Телефон
suppliersInfosupplierInfoindividualPersonRFIndEntrotherInfopostAddressInfomailFacilityName	Информация_о_поставщиках_Физлицо_РФ-ИП_Почта_Наименование_объекта_почтовой_связи
suppliersInfosupplierInfoindividualPersonRFIndEntrotherInfopostAddressInfomailingAdress	Информация_о_поставщиках_Физлицо_РФ-ИП_Почта_Адрес_пользователя
suppliersInfosupplierInfoindividualPersonRFIndEntrotherInfopostAddressInfopostBoxNumber	Информация_о_поставщиках_Физлицо_РФ-ИП_Почта_Номер_ячейки
suppliersInfosupplierInfoindividualPersonRFIndEntrotherInfostatus	Информация_о_поставщиках_Физлицо_РФ-ИП_Статус
suppliersInfosupplierInfoindividualPersonRFaddress	Информация_о_поставщиках_Физлицо_РФ__Адрес_места_нахождения
suppliersInfosupplierInfoindividualPersonRFcontactEMail	Информация_о_поставщиках_Физлицо_РФ_EMAIL
suppliersInfosupplierInfoindividualPersonRFcontactPhone	Информация_о_поставщиках_Физлицо_РФ_Телефон
suppliersInfosupplierInfoindividualPersonRFfirstName	Информация_о_поставщиках_Физлицо_РФ_Имя
suppliersInfosupplierInfoindividualPersonRFlastName	Информация_о_поставщиках_Физлицо_РФ_Фамилия
suppliersInfosupplierInfoindividualPersonRFmiddleName	Информация_о_поставщиках_Физлицо_РФ_Отчество
suppliersInfosupplierInfoindividualPersonRFpostAddressInfomailFacilityName	Информация_о_поставщиках_Физлицо_РФ_Почта_Наименование_объекта_почтовой_связи
suppliersInfosupplierInfoindividualPersonRFpostAddressInfomailingAdress	Информация_о_поставщиках_Физлицо_РФ_Почта_Адрес_пользователя
suppliersInfosupplierInfoindividualPersonRFpostAddressInfopostBoxNumber	Информация_о_поставщиках_Физлицо_РФ_Почта_Номер_ячейки
suppliersInfosupplierInfolegalEntityForeignStatefullName	Информация_о_поставщиках_Юридическое_лицо_иностранного_государства_Полное_наименование
suppliersInfosupplierInfolegalEntityForeignStateshortName	Информация_о_поставщиках_Юридическое_лицо_иностранного_государства_Краткое_наименование
suppliersInfosupplierInfolegalEntityRFEGRULInfoINN	Информация_о_поставщиках_Юридическое_лицо_ЕГРЮЛ_ИНН
suppliersInfosupplierInfolegalEntityRFEGRULInfoKPP	Информация_о_поставщиках_Юридическое_лицо_ЕГРЮЛ_КПП
suppliersInfosupplierInfolegalEntityRFEGRULInfoOGRN	Информация_о_поставщиках_Юридическое_лицо_ЕГРЮЛ_ОГРН
suppliersInfosupplierInfolegalEntityRFEGRULInfoaddress	Информация_о_поставщиках_Юридическое_лицо_ЕГРЮЛ_Адрес_места_нахождения
suppliersInfosupplierInfolegalEntityRFEGRULInfofirmName	Информация_о_поставщиках_Юридическое_лицо_ЕГРЮЛ_Фирменное_наименование
suppliersInfosupplierInfolegalEntityRFEGRULInfofullName	Информация_о_поставщиках_Юридическое_лицо_ЕГРЮЛ_Полное_наименование
suppliersInfosupplierInfolegalEntityRFEGRULInfolegalFormsingularName	Информация_о_поставщиках_Юридическое_лицо_ЕГРЮЛ_Организационно-правовая_форма
suppliersInfosupplierInfolegalEntityRFEGRULInforegistrationDate	Информация_о_поставщиках_Юридическое_лицо_ЕГРЮЛ_Дата_постановки_на_учет
suppliersInfosupplierInfolegalEntityRFEGRULInfoshortName	Информация_о_поставщиках_Юридическое_лицо_ЕГРЮЛ_Краткое_наименование
suppliersInfosupplierInfolegalEntityRFlegalEntityRFSubdivisionEGRULInfoKPP	Информация_о_поставщиках_Филиал_юридического_лица_РФ_ЕГРЮЛ_КПП
suppliersInfosupplierInfolegalEntityRFlegalEntityRFSubdivisionEGRULInfoaddress	Информация_о_поставщиках_Филиал_юридического_лица_РФ_ЕГРЮЛ_Адрес_места_нахождения
suppliersInfosupplierInfolegalEntityRFlegalEntityRFSubdivisionEGRULInfofullName	Информация_о_поставщиках_Филиал_юридического_лица_РФ_ЕГРЮЛ_Полное_наименование
suppliersInfosupplierInfolegalEntityRFlegalEntityRFSubdivisionEGRULInfolegalFormsingularName	Информация_о_поставщиках_Филиал_юридического_лица_РФ_ЕГРЮЛ_Организационно-правовая_форма
suppliersInfosupplierInfolegalEntityRFlegalEntityRFSubdivisionEGRULInforegistrationDate	Информация_о_поставщиках_Филиал_юридического_лица_РФ_ЕГРЮЛ_Дата_постановки_на_учет
suppliersInfosupplierInfolegalEntityRFotherInfoOKPO	Информация_о_поставщиках_Юридическое_лицо_Прочее_ОКПО
suppliersInfosupplierInfolegalEntityRFotherInfoOKTMOname	Информация_о_поставщиках_Юридическое_лицо_Прочее_Код_территории_муниципального_образования
suppliersInfosupplierInfolegalEntityRFotherInfocontactEMail	Информация_о_поставщиках_Юридическое_лицо_Прочее_EMAIL
suppliersInfosupplierInfolegalEntityRFotherInfocontactInfofirstName	Информация_о_поставщиках_Юридическое_лицо_Прочее_Контактное_лицо_Имя
suppliersInfosupplierInfolegalEntityRFotherInfocontactInfolastName	Информация_о_поставщиках_Юридическое_лицо_Прочее_Контактное_лицо_Фамилия
suppliersInfosupplierInfolegalEntityRFotherInfocontactInfomiddleName	Информация_о_поставщиках_Юридическое_лицо_Прочее_Контактное_лицо_Отчество
suppliersInfosupplierInfolegalEntityRFotherInfocontactPhone	Информация_о_поставщиках_Юридическое_лицо_Прочее_Телефон
suppliersInfosupplierInfolegalEntityRFotherInfocontractPrice	Информация_о_поставщиках_Юридическое_лицо_Прочее_Размер_денежных_средств_направляемых_субъектам_малого_предпринимательства_социально_ориентированным_некоммерческим_орг
suppliersInfosupplierInfolegalEntityRFotherInfolargestTaxpayerKPP	Информация_о_поставщиках_Юридическое_лицо_Прочее_КПП_крупнейшего_налогоплательщика
suppliersInfosupplierInfolegalEntityRFotherInfopostAdressInfomailFacilityName	Информация_о_поставщиках_Юридическое_лицо_Прочее_Почта_Наименование_объекта_почтовой_связи
suppliersInfosupplierInfolegalEntityRFotherInfopostAdressInfomailingAdress	Информация_о_поставщиках_Юридическое_лицо_Прочее_Почта_Адрес_пользователя
suppliersInfosupplierInfolegalEntityRFotherInfopostAdressInfopostBoxNumber	Информация_о_поставщиках_Юридическое_лицо_Прочее_Почта_Номер_ячейки
suppliersInfosupplierInfolegalEntityRFotherInfostatus	Информация_о_поставщиках_Юридическое_лицо_Прочее_Статус
suppliersInfosupplierInfolegalFormsingularName	Информация_о_поставщиках_Организационно-правовая_форма_организации_Наименование_в_единственном_числе
supplierssupplierlegalEntityRFINN	Поставщики_Юридическое_лицо_ИНН
supplierssupplierlegalEntityRFKPP	Поставщики_Юридическое_лицо_КПП
supplierssupplierlegalEntityRFOKPO	Поставщики_Юридическое_лицо_ОКПО
supplierssupplierlegalEntityRFOKTMOname	Поставщики_Юридическое_лицо_Код_территории_муниципального_образования
supplierssupplierlegalEntityRFaddress	Поставщики_Юридическое_лицо_Адрес_места_нахождения
supplierssupplierlegalEntityRFcontactEMail	Поставщики_Юридическое_лицо_EMAIL
supplierssupplierlegalEntityRFcontactInfofirstName	Поставщики_Юридическое_лицо_Контактное_лицо_Имя
supplierssupplierlegalEntityRFcontactInfolastName	Поставщики_Юридическое_лицо_Контактное_лицо_Фамилия
supplierssupplierlegalEntityRFcontactInfomiddleName	Поставщики_Юридическое_лицо_Контактное_лицо_Отчество
supplierssupplierlegalEntityRFcontactPhone	Поставщики_Юридическое_лицо_Телефон
supplierssupplierlegalEntityRFfirmName	Поставщики_Юридическое_лицо_Фирменное_наименование
supplierssupplierlegalEntityRFfullName	Поставщики_Юридическое_лицо_Полное_наименование
supplierssupplierlegalEntityRFlegalFormsingularName	Поставщики_Юридическое_лицо_Организационно-правовая_форма
supplierssupplierlegalEntityRFpostAddress	Поставщики_Юридическое_лицо_Почтовый_адрес
supplierssupplierlegalEntityRFpostAdressInfomailFacilityName	Поставщики_Юридическое_лицо_Почта_Наименование_объекта_почтовой_связи
supplierssupplierlegalEntityRFpostAdressInfomailingAdress	Поставщики_Юридическое_лицо_Почта_Адрес_пользователя
supplierssupplierlegalEntityRFpostAdressInfopostBoxNumber	Поставщики_Юридическое_лицо_Почта_Номер_ячейки
supplierssupplierlegalEntityRFregistrationDate	Поставщики_Юридическое_лицо_Дата_постановки_на_учет
supplierssupplierlegalEntityRFshortName	Поставщики_Юридическое_лицо_Краткое_наименование
supplierssupplierlegalEntityRFstatus	Поставщики_Юридическое_лицо_Статус
supplierssupplierindividualBusinessmanRFINN	Поставщики_ИП_ИНН
supplierssupplierindividualBusinessmanRFKPP	Поставщики_ИП_КПП
supplierssupplierindividualBusinessmanRFlastName	Поставщики_ИП_Фамилия
supplierssupplierindividualBusinessmanRFfirstName	Поставщики_ИП_Имя
supplierssupplierindividualBusinessmanRFmiddleName	Поставщики_ИП_Отчество
supplierssupplierindividualBusinessmanRFaddress	Поставщики_ИП_Адрес_места_нахождения
supplierssupplierindividualBusinessmanRFFcontactEMail	Поставщики_ИП_EMAIL
supplierssupplierindividualBusinessmanRFcontactPhone	Поставщики_ИП_Телефон
supplierssupplierindividualBusinessmanRFpostAddress	Поставщики_ИП_Почтовый_адрес
supplierssupplierindividualBusinessmanRFpostAdressInfomailFacilityName	Поставщики_ИП_Почта_Наименование_объекта_почтовой_связи
supplierssupplierindividualBusinessmanRFpostAdressInfomailingAdress	Поставщики_ИП_Почта_Адрес_пользователя
supplierssupplierindividualBusinessmanRFFpostAdressInfopostBoxNumber	Поставщики_ИП_Почта_Номер_ячейки
supplierssupplierindividualBusinessmanRFregistrationDate	Поставщики_ИП_Дата_постановки_на_учет
supplierssupplierlegalFormsingularName	Поставщики_Наименование_в_единственном_числе
executionsexecutionpayDocToDocAcceptanceCompliancesdocAcceptancedocumentDate	Информация_об_исполнении_Соответствие_платежного_документа_документам_о_приемке_Дата
executionsexecutionpayDocToDocAcceptanceCompliancesdocAcceptancedocumentNum	Информация_об_исполнении_Соответствие_платежного_документа_документам_о_приемке_Номер
executionsexecutionpayDocToDocAcceptanceCompliancesdocAcceptancename	Информация_об_исполнении_Соответствие_платежного_документа_документам_о_приемке_Название
executionsexecutionpayDocpayDocTypeInfodocAcceptancePayDocpayDocToDocAcceptanceCompliancesdocAcceptancedocumentDate	Информация_об_исполнении_Соответствие_платежного_документа_документам_о_приемке_Дата
executionsexecutionpayDocpayDocTypeInfodocAcceptancePayDocpayDocToDocAcceptanceCompliancesdocAcceptancedocumentNum	Информация_об_исполнении_Соответствие_платежного_документа_документам_о_приемке_Номер
executionsexecutionpayDocpayDocTypeInfodocAcceptancePayDocpayDocToDocAcceptanceCompliancesdocAcceptancename	Информация_об_исполнении_Соответствие_платежного_документа_документам_о_приемке_Название
productsproductsChangechangeInfo	Объекты_закупки_Сведения_об_изменении_объектов_закупки_Информация
productsproductsChangedocumentsdocumentDate	Объекты_закупки_Сведения_об_изменении_объектов_закупки_Документ_Дата
productsproductsChangedocumentsdocumentName	Объекты_закупки_Сведения_об_изменении_объектов_закупки_Документ_Название
productsproductsChangedocumentsdocumentNum	Объекты_закупки_Сведения_об_изменении_объектов_закупки__Документ_Номер
qualityGuaranteeInfonotPublishedOnEIS	Информация_о_гарантии_Нет_инфо_о_сроке_гарантии
qualityGuaranteeInfoprovidedPeriodotherPeriodText	Информация_о_гарантии_Срок_гарантии
qualityGuaranteeInfowarrantyReqsText	Информация_о_гарантии_Информация_о_требованиях_к_гарантийному_обслуживанию_товара
advancePaymentSumpriceValue	Размер_аванса_в_валюте_контракта
advancePaymentSumpriceValueRUR	Размер_аванса_в_рублевом_эквиваленте
advancePaymentSumsumInPercents	Размер_аванса_в_процентах
