Suppliers	Поставщик

'legalEntityRF,legalForm':	'Организационно_правовая_форма_организации',
'legalEntityRF,fullName':	'Полное_наименование',
'legalEntityRF,shortName':	'Сокращенное_наименование',
'legalEntityRF,firmName':	'Фирменное_наименование',
'legalEntityRF,lastName':	'Фамилия',
'legalEntityRF,firstName':	'Имя',
'legalEntityRF,middleName':	'Отчество',
'legalEntityRF,lastNameLat':	'Фамилия_латинскими_буквами',
'legalEntityRF,firstNameLat':	'Имя_латинскими_буквами',
'legalEntityRF,middleNameLat':	'Отчество_латинскими_буквами',
'legalEntityRF,isIP':	'Индивидуальный_предприниматель',
'legalEntityRF,status':	'Статус_поставщика',
'legalEntityRF,ERSMSPInclusionDate':	'Дата_включения_в_Единый_реестр',
'legalEntityRF,contractPrice':	'Размер_денежных_средств_благотворительность',
'legalEntityRF,OKPO':	'ОКПО',
'legalEntityRF,INN':	'ИНН',
'legalEntityRF,KPP':	'КПП',
'legalEntityRF,registrationDate':	'Дата_постановки_на_учет_в_налоговом_органе',
'legalEntityRF,OKTMO':	'ОКТМО',
'legalEntityRF,personalAccount':	'Номер_лицевого_счета',
'legalEntityRF,address':	'Адрес_места_нахождения',
'legalEntityRF,adress':	'Адрес_места_нахождения',
'legalEntityRF,postAdressInfo,mailingAdress':	'Почтовый_адрес_пользователя',
'legalEntityRF,postAdressInfo,mailFacilityName':	'Наименование_объекта_почтовой_связи',
'legalEntityRF,postAdressInfo,postBoxNumber':	'Номер_ячейки_абонементного_почтового_шкафа',
'legalEntityRF,postAddressInfo,mailingAdress':	'Почтовый_адрес_пользователя',
'legalEntityRF,postAddressInfo,mailFacilityName':	'Наименование_объекта_почтовой_связи',
'legalEntityRF,postAddressInfo,postBoxNumber':	'Номер_ячейки_абонементного_почтового_шкафа',
'legalEntityRF,postAddress':	'Почтовый_адрес',
'legalEntityRF,postAdress':	'Почтовый_адрес',
'legalEntityRF,contactInfo':	'Контактная_информация',
'legalEntityRF,contactEMail':	'E_mail_адрес_контактного_лица',
'legalEntityRF,contactPhone':	'Телефон_контактного_лица',
'legalEntityRF,isSubdivision':	'Является_филиалом_юридического_лица_РФ',
'legalEntityRF,largestTaxpayerKPP':	'КПП_крупнейшего_налогоплательщика',
'legalEntityRF,fullNameLat':	'Полное_наименование_латин',
'legalEntityRF,taxPayerCode':	'Код_налогоплательщика_в_стране_регистрации',
'legalEntityRF,registerInRFTaxBodies,INN':	'ИНН',
'legalEntityRF,registerInRFTaxBodies,KPP':	'КПП',
'legalEntityRF,registerInRFTaxBodies,registrationDate':	'Дата_постановки_на_учет_в_налоговом_органе',
'legalEntityRF,placeOfStayInRegCountry,country':	'Страна_регистрации',
'legalEntityRF,placeOfStayInRegCountry,address':	'Адрес_места_нахождения_в_стране_регистрации',
'legalEntityRF,placeOfStayInRegCountry,postAddress':	'Почтовый_адрес_в_стране_регистрации',
'legalEntityRF,placeOfStayInRegCountry,contactEMail':	'Электронная_почта',
'legalEntityRF,placeOfStayInRegCountry,contactPhone':	'Телефон_в_стране_регистрации',
'legalEntityRF,placeOfStayInRF,OKTMO':	'ОКТМО',
'legalEntityRF,placeOfStayInRF,address':	'Адрес_места_нахождения',
'legalEntityRF,placeOfStayInRF,adress':	'Адрес_места_нахождения',
'legalEntityRF,placeOfStayInRF,postAdressInfo,mailingAdress':	'Почтовый_адрес_пользователя',
'legalEntityRF,placeOfStayInRF,postAdressInfo,mailFacilityName':	'Наименование_объекта_почтовой_связи',
'legalEntityRF,placeOfStayInRF,postAdressInfo,postBoxNumber':	'Номер_ячейки_абонементного_почтового_шкафа',
'legalEntityRF,placeOfStayInRF,postAddressInfo,mailingAdress':	'Почтовый_адрес_пользователя',
'legalEntityRF,placeOfStayInRF,postAddressInfo,mailFacilityName':	'Наименование_объекта_почтовой_связи',
'legalEntityRF,placeOfStayInRF,postAddressInfo,postBoxNumber':	'Номер_ячейки_абонементного_почтового_шкафа',
'legalEntityRF,placeOfStayInRF,postAddress':	'Почтовый_адрес',
'legalEntityRF,placeOfStayInRF,postAdress':	'Почтовый_адрес',
'legalEntityRF,contactEMail':	'E_mail_адрес_контактного_лица',
'legalEntityRF,contactPhone':	'Телефон',
'legalEntityRF,isCulture':	'Поставщик_культурных_ценностей',
'legalEntityRF,supplierAccountsDetails,supplierAccountDetails,personalAccountNumber':	'Реквизиты_счета_Личный_счет',
'legalEntityRF,supplierAccountsDetails,supplierAccountDetails,creditOrgName':	'Реквизиты_счета_Наименование_кредитной_организации',
'legalEntityRF,supplierAccountsDetails,supplierAccountDetails,bankAccountNumber':	'Реквизиты_счета_Номер_счета',
'legalEntityRF,supplierAccountsDetails,supplierAccountDetails,bik':	'Реквизиты_счета_БИК_банка',
'legalEntityRF,supplierAccountsDetails,supplierAccountDetails,corrAccountNumber':	'Реквизиты_счета_Корр_счет',
'legalEntityForeignState,legalForm':	'Организационно_правовая_форма_организации',
'legalEntityForeignState,fullName':	'Полное_наименование',
'legalEntityForeignState,shortName':	'Сокращенное_наименование',
'legalEntityForeignState,firmName':	'Фирменное_наименование',
'legalEntityForeignState,lastName':	'Фамилия',
'legalEntityForeignState,firstName':	'Имя',
'legalEntityForeignState,middleName':	'Отчество',
'legalEntityForeignState,lastNameLat':	'Фамилия_латинскими_буквами',
'legalEntityForeignState,firstNameLat':	'Имя_латинскими_буквами',
'legalEntityForeignState,middleNameLat':	'Отчество_латинскими_буквами',
'legalEntityForeignState,isIP':	'Индивидуальный_предприниматель',
'legalEntityForeignState,status':	'Статус_поставщика',
'legalEntityForeignState,ERSMSPInclusionDate':	'Дата_включения_в_Единый_реестр',
'legalEntityForeignState,contractPrice':	'Размер_денежных_средств_благотворительность',
'legalEntityForeignState,OKPO':	'ОКПО',
'legalEntityForeignState,INN':	'ИНН',
'legalEntityForeignState,KPP':	'КПП',
'legalEntityForeignState,registrationDate':	'Дата_постановки_на_учет_в_налоговом_органе',
'legalEntityForeignState,OKTMO':	'ОКТМО',
'legalEntityForeignState,personalAccount':	'Номер_лицевого_счета',
'legalEntityForeignState,address':	'Адрес_места_нахождения',
'legalEntityForeignState,adress':	'Адрес_места_нахождения',
'legalEntityForeignState,postAdressInfo,mailingAdress':	'Почтовый_адрес_пользователя',
'legalEntityForeignState,postAdressInfo,mailFacilityName':	'Наименование_объекта_почтовой_связи',
'legalEntityForeignState,postAdressInfo,postBoxNumber':	'Номер_ячейки_абонементного_почтового_шкафа',
'legalEntityForeignState,postAddressInfo,mailingAdress':	'Почтовый_адрес_пользователя',
'legalEntityForeignState,postAddressInfo,mailFacilityName':	'Наименование_объекта_почтовой_связи',
'legalEntityForeignState,postAddressInfo,postBoxNumber':	'Номер_ячейки_абонементного_почтового_шкафа',
'legalEntityForeignState,postAddress':	'Почтовый_адрес',
'legalEntityForeignState,postAdress':	'Почтовый_адрес',
'legalEntityForeignState,contactInfo':	'Контактная_информация',
'legalEntityForeignState,contactEMail':	'E_mail_адрес_контактного_лица',
'legalEntityForeignState,contactPhone':	'Телефон_контактного_лица',
'legalEntityForeignState,isSubdivision':	'Является_филиалом_юридического_лица_РФ',
'legalEntityForeignState,largestTaxpayerKPP':	'КПП_крупнейшего_налогоплательщика',
'legalEntityForeignState,fullNameLat':	'Полное_наименование_латин',
'legalEntityForeignState,taxPayerCode':	'Код_налогоплательщика_в_стране_регистрации',
'legalEntityForeignState,registerInRFTaxBodies,INN':	'ИНН',
'legalEntityForeignState,registerInRFTaxBodies,KPP':	'КПП',
'legalEntityForeignState,registerInRFTaxBodies,registrationDate':	'Дата_постановки_на_учет_в_налоговом_органе',
'legalEntityForeignState,placeOfStayInRegCountry,country':	'Страна_регистрации',
'legalEntityForeignState,placeOfStayInRegCountry,address':	'Адрес_места_нахождения_в_стране_регистрации',
'legalEntityForeignState,placeOfStayInRegCountry,postAddress':	'Почтовый_адрес_в_стране_регистрации',
'legalEntityForeignState,placeOfStayInRegCountry,contactEMail':	'Электронная_почта',
'legalEntityForeignState,placeOfStayInRegCountry,contactPhone':	'Телефон_в_стране_регистрации',
'legalEntityForeignState,placeOfStayInRF,OKTMO':	'ОКТМО',
'legalEntityForeignState,placeOfStayInRF,address':	'Адрес_места_нахождения',
'legalEntityForeignState,placeOfStayInRF,adress':	'Адрес_места_нахождения',
'legalEntityForeignState,placeOfStayInRF,postAdressInfo,mailingAdress':	'Почтовый_адрес_пользователя',
'legalEntityForeignState,placeOfStayInRF,postAdressInfo,mailFacilityName':	'Наименование_объекта_почтовой_связи',
'legalEntityForeignState,placeOfStayInRF,postAdressInfo,postBoxNumber':	'Номер_ячейки_абонементного_почтового_шкафа',
'legalEntityForeignState,placeOfStayInRF,postAddressInfo,mailingAdress':	'Почтовый_адрес_пользователя',
'legalEntityForeignState,placeOfStayInRF,postAddressInfo,mailFacilityName':	'Наименование_объекта_почтовой_связи',
'legalEntityForeignState,placeOfStayInRF,postAddressInfo,postBoxNumber':	'Номер_ячейки_абонементного_почтового_шкафа',
'legalEntityForeignState,placeOfStayInRF,postAddress':	'Почтовый_адрес',
'legalEntityForeignState,placeOfStayInRF,postAdress':	'Почтовый_адрес',
'legalEntityForeignState,contactEMail':	'E_mail_адрес_контактного_лица',
'legalEntityForeignState,contactPhone':	'Телефон',
'legalEntityForeignState,isCulture':	'Поставщик_культурных_ценностей',
'legalEntityForeignState,supplierAccountsDetails,supplierAccountDetails,personalAccountNumber':	'Реквизиты_счета_Личный_счет',
'legalEntityForeignState,supplierAccountsDetails,supplierAccountDetails,creditOrgName':	'Реквизиты_счета_Наименование_кредитной_организации',
'legalEntityForeignState,supplierAccountsDetails,supplierAccountDetails,bankAccountNumber':	'Реквизиты_счета_Номер_счета',
'legalEntityForeignState,supplierAccountsDetails,supplierAccountDetails,bik':	'Реквизиты_счета_БИК_банка',
'legalEntityForeignState,supplierAccountsDetails,supplierAccountDetails,corrAccountNumber':	'Реквизиты_счета_Корр_счет',
'individualPersonRF,legalForm':	'Организационно_правовая_форма_организации',
'individualPersonRF,fullName':	'Полное_наименование',
'individualPersonRF,shortName':	'Сокращенное_наименование',
'individualPersonRF,firmName':	'Фирменное_наименование',
'individualPersonRF,lastName':	'Фамилия',
'individualPersonRF,firstName':	'Имя',
'individualPersonRF,middleName':	'Отчество',
'individualPersonRF,lastNameLat':	'Фамилия_латинскими_буквами',
'individualPersonRF,firstNameLat':	'Имя_латинскими_буквами',
'individualPersonRF,middleNameLat':	'Отчество_латинскими_буквами',
'individualPersonRF,isIP':	'Индивидуальный_предприниматель',
'individualPersonRF,status':	'Статус_поставщика',
'individualPersonRF,ERSMSPInclusionDate':	'Дата_включения_в_Единый_реестр',
'individualPersonRF,contractPrice':	'Размер_денежных_средств_благотворительность',
'individualPersonRF,OKPO':	'ОКПО',
'individualPersonRF,INN':	'ИНН',
'individualPersonRF,KPP':	'КПП',
'individualPersonRF,registrationDate':	'Дата_постановки_на_учет_в_налоговом_органе',
'individualPersonRF,OKTMO':	'ОКТМО',
'individualPersonRF,personalAccount':	'Номер_лицевого_счета',
'individualPersonRF,address':	'Адрес_места_нахождения',
'individualPersonRF,adress':	'Адрес_места_нахождения',
'individualPersonRF,postAdressInfo,mailingAdress':	'Почтовый_адрес_пользователя',
'individualPersonRF,postAdressInfo,mailFacilityName':	'Наименование_объекта_почтовой_связи',
'individualPersonRF,postAdressInfo,postBoxNumber':	'Номер_ячейки_абонементного_почтового_шкафа',
'individualPersonRF,postAddressInfo,mailingAdress':	'Почтовый_адрес_пользователя',
'individualPersonRF,postAddressInfo,mailFacilityName':	'Наименование_объекта_почтовой_связи',
'individualPersonRF,postAddressInfo,postBoxNumber':	'Номер_ячейки_абонементного_почтового_шкафа',
'individualPersonRF,postAddress':	'Почтовый_адрес',
'individualPersonRF,postAdress':	'Почтовый_адрес',
'individualPersonRF,contactInfo':	'Контактная_информация',
'individualPersonRF,contactEMail':	'E_mail_адрес_контактного_лица',
'individualPersonRF,contactPhone':	'Телефон_контактного_лица',
'individualPersonRF,isSubdivision':	'Является_филиалом_юридического_лица_РФ',
'individualPersonRF,largestTaxpayerKPP':	'КПП_крупнейшего_налогоплательщика',
'individualPersonRF,fullNameLat':	'Полное_наименование_латин',
'individualPersonRF,taxPayerCode':	'Код_налогоплательщика_в_стране_регистрации',
'individualPersonRF,registerInRFTaxBodies,INN':	'ИНН',
'individualPersonRF,registerInRFTaxBodies,KPP':	'КПП',
'individualPersonRF,registerInRFTaxBodies,registrationDate':	'Дата_постановки_на_учет_в_налоговом_органе',
'individualPersonRF,placeOfStayInRegCountry,country':	'Страна_регистрации',
'individualPersonRF,placeOfStayInRegCountry,address':	'Адрес_места_нахождения_в_стране_регистрации',
'individualPersonRF,placeOfStayInRegCountry,postAddress':	'Почтовый_адрес_в_стране_регистрации',
'individualPersonRF,placeOfStayInRegCountry,contactEMail':	'Электронная_почта',
'individualPersonRF,placeOfStayInRegCountry,contactPhone':	'Телефон_в_стране_регистрации',
'individualPersonRF,placeOfStayInRF,OKTMO':	'ОКТМО',
'individualPersonRF,placeOfStayInRF,address':	'Адрес_места_нахождения',
'individualPersonRF,placeOfStayInRF,adress':	'Адрес_места_нахождения',
'individualPersonRF,placeOfStayInRF,postAdressInfo,mailingAdress':	'Почтовый_адрес_пользователя',
'individualPersonRF,placeOfStayInRF,postAdressInfo,mailFacilityName':	'Наименование_объекта_почтовой_связи',
'individualPersonRF,placeOfStayInRF,postAdressInfo,postBoxNumber':	'Номер_ячейки_абонементного_почтового_шкафа',
'individualPersonRF,placeOfStayInRF,postAddressInfo,mailingAdress':	'Почтовый_адрес_пользователя',
'individualPersonRF,placeOfStayInRF,postAddressInfo,mailFacilityName':	'Наименование_объекта_почтовой_связи',
'individualPersonRF,placeOfStayInRF,postAddressInfo,postBoxNumber':	'Номер_ячейки_абонементного_почтового_шкафа',
'individualPersonRF,placeOfStayInRF,postAddress':	'Почтовый_адрес',
'individualPersonRF,placeOfStayInRF,postAdress':	'Почтовый_адрес',
'individualPersonRF,contactEMail':	'E_mail_адрес_контактного_лица',
'individualPersonRF,contactPhone':	'Телефон',
'individualPersonRF,isCulture':	'Поставщик_культурных_ценностей',
'individualPersonRF,supplierAccountsDetails,supplierAccountDetails,personalAccountNumber':	'Реквизиты_счета_Личный_счет',
'individualPersonRF,supplierAccountsDetails,supplierAccountDetails,creditOrgName':	'Реквизиты_счета_Наименование_кредитной_организации',
'individualPersonRF,supplierAccountsDetails,supplierAccountDetails,bankAccountNumber':	'Реквизиты_счета_Номер_счета',
'individualPersonRF,supplierAccountsDetails,supplierAccountDetails,bik':	'Реквизиты_счета_БИК_банка',
'individualPersonRF,supplierAccountsDetails,supplierAccountDetails,corrAccountNumber':	'Реквизиты_счета_Корр_счет',
'individualPersonForeignState,legalForm':	'Организационно_правовая_форма_организации',
'individualPersonForeignState,fullName':	'Полное_наименование',
'individualPersonForeignState,shortName':	'Сокращенное_наименование',
'individualPersonForeignState,firmName':	'Фирменное_наименование',
'individualPersonForeignState,lastName':	'Фамилия',
'individualPersonForeignState,firstName':	'Имя',
'individualPersonForeignState,middleName':	'Отчество',
'individualPersonForeignState,lastNameLat':	'Фамилия_латинскими_буквами',
'individualPersonForeignState,firstNameLat':	'Имя_латинскими_буквами',
'individualPersonForeignState,middleNameLat':	'Отчество_латинскими_буквами',
'individualPersonForeignState,isIP':	'Индивидуальный_предприниматель',
'individualPersonForeignState,status':	'Статус_поставщика',
'individualPersonForeignState,ERSMSPInclusionDate':	'Дата_включения_в_Единый_реестр',
'individualPersonForeignState,contractPrice':	'Размер_денежных_средств_благотворительность',
'individualPersonForeignState,OKPO':	'ОКПО',
'individualPersonForeignState,INN':	'ИНН',
'individualPersonForeignState,KPP':	'КПП',
'individualPersonForeignState,registrationDate':	'Дата_постановки_на_учет_в_налоговом_органе',
'individualPersonForeignState,OKTMO':	'ОКТМО',
'individualPersonForeignState,personalAccount':	'Номер_лицевого_счета',
'individualPersonForeignState,address':	'Адрес_места_нахождения',
'individualPersonForeignState,adress':	'Адрес_места_нахождения',
'individualPersonForeignState,postAdressInfo,mailingAdress':	'Почтовый_адрес_пользователя',
'individualPersonForeignState,postAdressInfo,mailFacilityName':	'Наименование_объекта_почтовой_связи',
'individualPersonForeignState,postAdressInfo,postBoxNumber':	'Номер_ячейки_абонементного_почтового_шкафа',
'individualPersonForeignState,postAddressInfo,mailingAdress':	'Почтовый_адрес_пользователя',
'individualPersonForeignState,postAddressInfo,mailFacilityName':	'Наименование_объекта_почтовой_связи',
'individualPersonForeignState,postAddressInfo,postBoxNumber':	'Номер_ячейки_абонементного_почтового_шкафа',
'individualPersonForeignState,postAddress':	'Почтовый_адрес',
'individualPersonForeignState,postAdress':	'Почтовый_адрес',
'individualPersonForeignState,contactInfo':	'Контактная_информация',
'individualPersonForeignState,contactEMail':	'E_mail_адрес_контактного_лица',
'individualPersonForeignState,contactPhone':	'Телефон_контактного_лица',
'individualPersonForeignState,isSubdivision':	'Является_филиалом_юридического_лица_РФ',
'individualPersonForeignState,largestTaxpayerKPP':	'КПП_крупнейшего_налогоплательщика',
'individualPersonForeignState,fullNameLat':	'Полное_наименование_латин',
'individualPersonForeignState,taxPayerCode':	'Код_налогоплательщика_в_стране_регистрации',
'individualPersonForeignState,registerInRFTaxBodies,INN':	'ИНН',
'individualPersonForeignState,registerInRFTaxBodies,KPP':	'КПП',
'individualPersonForeignState,registerInRFTaxBodies,registrationDate':	'Дата_постановки_на_учет_в_налоговом_органе',
'individualPersonForeignState,placeOfStayInRegCountry,country':	'Страна_регистрации',
'individualPersonForeignState,placeOfStayInRegCountry,address':	'Адрес_места_нахождения_в_стране_регистрации',
'individualPersonForeignState,placeOfStayInRegCountry,postAddress':	'Почтовый_адрес_в_стране_регистрации',
'individualPersonForeignState,placeOfStayInRegCountry,contactEMail':	'Электронная_почта',
'individualPersonForeignState,placeOfStayInRegCountry,contactPhone':	'Телефон_в_стране_регистрации',
'individualPersonForeignState,placeOfStayInRF,OKTMO':	'ОКТМО',
'individualPersonForeignState,placeOfStayInRF,address':	'Адрес_места_нахождения',
'individualPersonForeignState,placeOfStayInRF,adress':	'Адрес_места_нахождения',
'individualPersonForeignState,placeOfStayInRF,postAdressInfo,mailingAdress':	'Почтовый_адрес_пользователя',
'individualPersonForeignState,placeOfStayInRF,postAdressInfo,mailFacilityName':	'Наименование_объекта_почтовой_связи',
'individualPersonForeignState,placeOfStayInRF,postAdressInfo,postBoxNumber':	'Номер_ячейки_абонементного_почтового_шкафа',
'individualPersonForeignState,placeOfStayInRF,postAddressInfo,mailingAdress':	'Почтовый_адрес_пользователя',
'individualPersonForeignState,placeOfStayInRF,postAddressInfo,mailFacilityName':	'Наименование_объекта_почтовой_связи',
'individualPersonForeignState,placeOfStayInRF,postAddressInfo,postBoxNumber':	'Номер_ячейки_абонементного_почтового_шкафа',
'individualPersonForeignState,placeOfStayInRF,postAddress':	'Почтовый_адрес',
'individualPersonForeignState,placeOfStayInRF,postAdress':	'Почтовый_адрес',
'individualPersonForeignState,contactEMail':	'E_mail_адрес_контактного_лица',
'individualPersonForeignState,contactPhone':	'Телефон',
'individualPersonForeignState,isCulture':	'Поставщик_культурных_ценностей',
'individualPersonForeignState,supplierAccountsDetails,supplierAccountDetails,personalAccountNumber':	'Реквизиты_счета_Личный_счет',
'individualPersonForeignState,supplierAccountsDetails,supplierAccountDetails,creditOrgName':	'Реквизиты_счета_Наименование_кредитной_организации',
'individualPersonForeignState,supplierAccountsDetails,supplierAccountDetails,bankAccountNumber':	'Реквизиты_счета_Номер_счета',
'individualPersonForeignState,supplierAccountsDetails,supplierAccountDetails,bik':	'Реквизиты_счета_БИК_банка',
'individualPersonForeignState,supplierAccountsDetails,supplierAccountDetails,corrAccountNumber':	'Реквизиты_счета_Корр_счет',
'individualPersonRFisCulture,legalForm':	'Организационно_правовая_форма_организации',
'individualPersonRFisCulture,fullName':	'Полное_наименование',
'individualPersonRFisCulture,shortName':	'Сокращенное_наименование',
'individualPersonRFisCulture,firmName':	'Фирменное_наименование',
'individualPersonRFisCulture,lastName':	'Фамилия',
'individualPersonRFisCulture,firstName':	'Имя',
'individualPersonRFisCulture,middleName':	'Отчество',
'individualPersonRFisCulture,lastNameLat':	'Фамилия_латинскими_буквами',
'individualPersonRFisCulture,firstNameLat':	'Имя_латинскими_буквами',
'individualPersonRFisCulture,middleNameLat':	'Отчество_латинскими_буквами',
'individualPersonRFisCulture,isIP':	'Индивидуальный_предприниматель',
'individualPersonRFisCulture,status':	'Статус_поставщика',
'individualPersonRFisCulture,ERSMSPInclusionDate':	'Дата_включения_в_Единый_реестр',
'individualPersonRFisCulture,contractPrice':	'Размер_денежных_средств_благотворительность',
'individualPersonRFisCulture,OKPO':	'ОКПО',
'individualPersonRFisCulture,INN':	'ИНН',
'individualPersonRFisCulture,KPP':	'КПП',
'individualPersonRFisCulture,registrationDate':	'Дата_постановки_на_учет_в_налоговом_органе',
'individualPersonRFisCulture,OKTMO':	'ОКТМО',
'individualPersonRFisCulture,personalAccount':	'Номер_лицевого_счета',
'individualPersonRFisCulture,address':	'Адрес_места_нахождения',
'individualPersonRFisCulture,adress':	'Адрес_места_нахождения',
'individualPersonRFisCulture,postAdressInfo,mailingAdress':	'Почтовый_адрес_пользователя',
'individualPersonRFisCulture,postAdressInfo,mailFacilityName':	'Наименование_объекта_почтовой_связи',
'individualPersonRFisCulture,postAdressInfo,postBoxNumber':	'Номер_ячейки_абонементного_почтового_шкафа',
'individualPersonRFisCulture,postAddressInfo,mailingAdress':	'Почтовый_адрес_пользователя',
'individualPersonRFisCulture,postAddressInfo,mailFacilityName':	'Наименование_объекта_почтовой_связи',
'individualPersonRFisCulture,postAddressInfo,postBoxNumber':	'Номер_ячейки_абонементного_почтового_шкафа',
'individualPersonRFisCulture,postAddress':	'Почтовый_адрес',
'individualPersonRFisCulture,postAdress':	'Почтовый_адрес',
'individualPersonRFisCulture,contactInfo':	'Контактная_информация',
'individualPersonRFisCulture,contactEMail':	'E_mail_адрес_контактного_лица',
'individualPersonRFisCulture,contactPhone':	'Телефон_контактного_лица',
'individualPersonRFisCulture,isSubdivision':	'Является_филиалом_юридического_лица_РФ',
'individualPersonRFisCulture,largestTaxpayerKPP':	'КПП_крупнейшего_налогоплательщика',
'individualPersonRFisCulture,fullNameLat':	'Полное_наименование_латин',
'individualPersonRFisCulture,taxPayerCode':	'Код_налогоплательщика_в_стране_регистрации',
'individualPersonRFisCulture,registerInRFTaxBodies,INN':	'ИНН',
'individualPersonRFisCulture,registerInRFTaxBodies,KPP':	'КПП',
'individualPersonRFisCulture,registerInRFTaxBodies,registrationDate':	'Дата_постановки_на_учет_в_налоговом_органе',
'individualPersonRFisCulture,placeOfStayInRegCountry,country':	'Страна_регистрации',
'individualPersonRFisCulture,placeOfStayInRegCountry,address':	'Адрес_места_нахождения_в_стране_регистрации',
'individualPersonRFisCulture,placeOfStayInRegCountry,postAddress':	'Почтовый_адрес_в_стране_регистрации',
'individualPersonRFisCulture,placeOfStayInRegCountry,contactEMail':	'Электронная_почта',
'individualPersonRFisCulture,placeOfStayInRegCountry,contactPhone':	'Телефон_в_стране_регистрации',
'individualPersonRFisCulture,placeOfStayInRF,OKTMO':	'ОКТМО',
'individualPersonRFisCulture,placeOfStayInRF,address':	'Адрес_места_нахождения',
'individualPersonRFisCulture,placeOfStayInRF,adress':	'Адрес_места_нахождения',
'individualPersonRFisCulture,placeOfStayInRF,postAdressInfo,mailingAdress':	'Почтовый_адрес_пользователя',
'individualPersonRFisCulture,placeOfStayInRF,postAdressInfo,mailFacilityName':	'Наименование_объекта_почтовой_связи',
'individualPersonRFisCulture,placeOfStayInRF,postAdressInfo,postBoxNumber':	'Номер_ячейки_абонементного_почтового_шкафа',
'individualPersonRFisCulture,placeOfStayInRF,postAddressInfo,mailingAdress':	'Почтовый_адрес_пользователя',
'individualPersonRFisCulture,placeOfStayInRF,postAddressInfo,mailFacilityName':	'Наименование_объекта_почтовой_связи',
'individualPersonRFisCulture,placeOfStayInRF,postAddressInfo,postBoxNumber':	'Номер_ячейки_абонементного_почтового_шкафа',
'individualPersonRFisCulture,placeOfStayInRF,postAddress':	'Почтовый_адрес',
'individualPersonRFisCulture,placeOfStayInRF,postAdress':	'Почтовый_адрес',
'individualPersonRFisCulture,contactEMail':	'E_mail_адрес_контактного_лица',
'individualPersonRFisCulture,contactPhone':	'Телефон',
'individualPersonRFisCulture,isCulture':	'Поставщик_культурных_ценностей',
'individualPersonRFisCulture,supplierAccountsDetails,supplierAccountDetails,personalAccountNumber':	'Реквизиты_счета_Личный_счет',
'individualPersonRFisCulture,supplierAccountsDetails,supplierAccountDetails,creditOrgName':	'Реквизиты_счета_Наименование_кредитной_организации',
'individualPersonRFisCulture,supplierAccountsDetails,supplierAccountDetails,bankAccountNumber':	'Реквизиты_счета_Номер_счета',
'individualPersonRFisCulture,supplierAccountsDetails,supplierAccountDetails,bik':	'Реквизиты_счета_БИК_банка',
'individualPersonRFisCulture,supplierAccountsDetails,supplierAccountDetails,corrAccountNumber':	'Реквизиты_счета_Корр_счет',
'individualPersonForeignStateisCulture,legalForm':	'Организационно_правовая_форма_организации',
'individualPersonForeignStateisCulture,fullName':	'Полное_наименование',
'individualPersonForeignStateisCulture,shortName':	'Сокращенное_наименование',
'individualPersonForeignStateisCulture,firmName':	'Фирменное_наименование',
'individualPersonForeignStateisCulture,lastName':	'Фамилия',
'individualPersonForeignStateisCulture,firstName':	'Имя',
'individualPersonForeignStateisCulture,middleName':	'Отчество',
'individualPersonForeignStateisCulture,lastNameLat':	'Фамилия_латинскими_буквами',
'individualPersonForeignStateisCulture,firstNameLat':	'Имя_латинскими_буквами',
'individualPersonForeignStateisCulture,middleNameLat':	'Отчество_латинскими_буквами',
'individualPersonForeignStateisCulture,isIP':	'Индивидуальный_предприниматель',
'individualPersonForeignStateisCulture,status':	'Статус_поставщика',
'individualPersonForeignStateisCulture,ERSMSPInclusionDate':	'Дата_включения_в_Единый_реестр',
'individualPersonForeignStateisCulture,contractPrice':	'Размер_денежных_средств_благотворительность',
'individualPersonForeignStateisCulture,OKPO':	'ОКПО',
'individualPersonForeignStateisCulture,INN':	'ИНН',
'individualPersonForeignStateisCulture,KPP':	'КПП',
'individualPersonForeignStateisCulture,registrationDate':	'Дата_постановки_на_учет_в_налоговом_органе',
'individualPersonForeignStateisCulture,OKTMO':	'ОКТМО',
'individualPersonForeignStateisCulture,personalAccount':	'Номер_лицевого_счета',
'individualPersonForeignStateisCulture,address':	'Адрес_места_нахождения',
'individualPersonForeignStateisCulture,adress':	'Адрес_места_нахождения',
'individualPersonForeignStateisCulture,postAdressInfo,mailingAdress':	'Почтовый_адрес_пользователя',
'individualPersonForeignStateisCulture,postAdressInfo,mailFacilityName':	'Наименование_объекта_почтовой_связи',
'individualPersonForeignStateisCulture,postAdressInfo,postBoxNumber':	'Номер_ячейки_абонементного_почтового_шкафа',
'individualPersonForeignStateisCulture,postAddressInfo,mailingAdress':	'Почтовый_адрес_пользователя',
'individualPersonForeignStateisCulture,postAddressInfo,mailFacilityName':	'Наименование_объекта_почтовой_связи',
'individualPersonForeignStateisCulture,postAddressInfo,postBoxNumber':	'Номер_ячейки_абонементного_почтового_шкафа',
'individualPersonForeignStateisCulture,postAddress':	'Почтовый_адрес',
'individualPersonForeignStateisCulture,postAdress':	'Почтовый_адрес',
'individualPersonForeignStateisCulture,contactInfo':	'Контактная_информация',
'individualPersonForeignStateisCulture,contactEMail':	'E_mail_адрес_контактного_лица',
'individualPersonForeignStateisCulture,contactPhone':	'Телефон_контактного_лица',
'individualPersonForeignStateisCulture,isSubdivision':	'Является_филиалом_юридического_лица_РФ',
'individualPersonForeignStateisCulture,largestTaxpayerKPP':	'КПП_крупнейшего_налогоплательщика',
'individualPersonForeignStateisCulture,fullNameLat':	'Полное_наименование_латин',
'individualPersonForeignStateisCulture,taxPayerCode':	'Код_налогоплательщика_в_стране_регистрации',
'individualPersonForeignStateisCulture,registerInRFTaxBodies,INN':	'ИНН',
'individualPersonForeignStateisCulture,registerInRFTaxBodies,KPP':	'КПП',
'individualPersonForeignStateisCulture,registerInRFTaxBodies,registrationDate':	'Дата_постановки_на_учет_в_налоговом_органе',
'individualPersonForeignStateisCulture,placeOfStayInRegCountry,country':	'Страна_регистрации',
'individualPersonForeignStateisCulture,placeOfStayInRegCountry,address':	'Адрес_места_нахождения_в_стране_регистрации',
'individualPersonForeignStateisCulture,placeOfStayInRegCountry,postAddress':	'Почтовый_адрес_в_стране_регистрации',
'individualPersonForeignStateisCulture,placeOfStayInRegCountry,contactEMail':	'Электронная_почта',
'individualPersonForeignStateisCulture,placeOfStayInRegCountry,contactPhone':	'Телефон_в_стране_регистрации',
'individualPersonForeignStateisCulture,placeOfStayInRF,OKTMO':	'ОКТМО',
'individualPersonForeignStateisCulture,placeOfStayInRF,address':	'Адрес_места_нахождения',
'individualPersonForeignStateisCulture,placeOfStayInRF,adress':	'Адрес_места_нахождения',
'individualPersonForeignStateisCulture,placeOfStayInRF,postAdressInfo,mailingAdress':	'Почтовый_адрес_пользователя',
'individualPersonForeignStateisCulture,placeOfStayInRF,postAdressInfo,mailFacilityName':	'Наименование_объекта_почтовой_связи',
'individualPersonForeignStateisCulture,placeOfStayInRF,postAdressInfo,postBoxNumber':	'Номер_ячейки_абонементного_почтового_шкафа',
'individualPersonForeignStateisCulture,placeOfStayInRF,postAddressInfo,mailingAdress':	'Почтовый_адрес_пользователя',
'individualPersonForeignStateisCulture,placeOfStayInRF,postAddressInfo,mailFacilityName':	'Наименование_объекта_почтовой_связи',
'individualPersonForeignStateisCulture,placeOfStayInRF,postAddressInfo,postBoxNumber':	'Номер_ячейки_абонементного_почтового_шкафа',
'individualPersonForeignStateisCulture,placeOfStayInRF,postAddress':	'Почтовый_адрес',
'individualPersonForeignStateisCulture,placeOfStayInRF,postAdress':	'Почтовый_адрес',
'individualPersonForeignStateisCulture,contactEMail':	'E_mail_адрес_контактного_лица',
'individualPersonForeignStateisCulture,contactPhone':	'Телефон',
'individualPersonForeignStateisCulture,isCulture':	'Поставщик_культурных_ценностей',
'individualPersonForeignStateisCulture,supplierAccountsDetails,supplierAccountDetails,personalAccountNumber':	'Реквизиты_счета_Личный_счет',
'individualPersonForeignStateisCulture,supplierAccountsDetails,supplierAccountDetails,creditOrgName':	'Реквизиты_счета_Наименование_кредитной_организации',
'individualPersonForeignStateisCulture,supplierAccountsDetails,supplierAccountDetails,bankAccountNumber':	'Реквизиты_счета_Номер_счета',
'individualPersonForeignStateisCulture,supplierAccountsDetails,supplierAccountDetails,bik':	'Реквизиты_счета_БИК_банка',
'individualPersonForeignStateisCulture,supplierAccountsDetails,supplierAccountDetails,corrAccountNumber':	'Реквизиты_счета_Корр_счет'
'legalEntityRF,EGRULInfo,OGRN':	'ОГРН',
'legalEntityRF,EGRULInfo,legalForm':	'Организационно_правовая_форма_организации',
'legalEntityRF,EGRULInfo,fullName':	'Полное_наименование',
'legalEntityRF,EGRULInfo,shortName':	'Сокращенное_наименование',
'legalEntityRF,EGRULInfo,firmName':	'Фирменное_наименование',
'legalEntityRF,EGRULInfo,INN':	'ИНН',
'legalEntityRF,EGRULInfo,KPP':	'КПП',
'legalEntityRF,EGRULInfo,registrationDate':	'Дата_постановки_на_учет_в_налоговом_органе',
'legalEntityRF,EGRULInfo,address':	'Адрес_места_нахождения',
'legalEntityRF,EGRULInfo,adress':	'Адрес_места_нахождения',
'legalEntityRF,isSubdivision':	'Является_филиалом_юридического_лица_РФ',
'legalEntityRF,otherInfo,status':	'Статус_поставщика',
'legalEntityRF,otherInfo,ERSMSPInclusionDate':	'Дата_включения_в_Единый_реестр',
'legalEntityRF,otherInfo,contractPrice':	'Размер_денежных_средств_благотворительность',
'legalEntityRF,otherInfo,OKPO':	'ОКПО',
'legalEntityRF,otherInfo,OKTMO':	'ОКТМО',
'legalEntityRF,otherInfo,personalAccount':	'Номер_лицевого_счета',
'legalEntityRF,otherInfo,postAdressInfo,mailingAdress':	'Почтовый_адрес_пользователя',
'legalEntityRF,otherInfo,postAdressInfo,mailFacilityName':	'Наименование_объекта_почтовой_связи',
'legalEntityRF,otherInfo,postAdressInfo,postBoxNumber':	'Номер_ячейки_абонементного_почтового_шкафа',
'legalEntityRF,otherInfo,postAddressInfo,mailingAdress':	'Почтовый_адрес_пользователя',
'legalEntityRF,otherInfo,postAddressInfo,mailFacilityName':	'Наименование_объекта_почтовой_связи',
'legalEntityRF,otherInfo,postAddressInfo,postBoxNumber':	'Номер_ячейки_абонементного_почтового_шкафа',
'legalEntityRF,contactInfo':	'Контактная_информация',
'legalEntityRF,contactEMail':	'E_mail_адрес_контактного_лица',
'legalEntityRF,contactPhone':	'Телефон_контактного_лица',
'legalEntityRF,largestTaxpayerKPP':	'КПП_крупнейшего_налогоплательщика',
'legalEntityRF,EGRIPInfo,OGRNIP':	'ОГРНИП',
'legalEntityRF,EGRIPInfo,lastName':	'Фамилия',
'legalEntityRF,EGRIPInfo,firstName':	'Имя',
'legalEntityRF,EGRIPInfo,middleName':	'Отчество',
'legalEntityRF,otherInfo,isIP':	'Индивидуальный_предприниматель',
'legalEntityRF,lastName':	'Фамилия',
'legalEntityRF,firstName':	'Имя',
'legalEntityRF,middleName':	'Отчество',
'legalEntityRF,INN':	'ИНН',
'legalEntityRF,registrationDate':	'Дата_постановки_на_учет_в_налоговом_органе',
'legalEntityRF,status':	'Статус_поставщика',
'legalEntityRF,ERSMSPInclusionDate':	'Дата_включения_в_Единый_реестр',
'legalEntityRF,OKTMO':	'ОКТМО',
'legalEntityRF,personalAccount':	'Номер_лицевого_счета',
'legalEntityRF,address':	'Адрес_места_нахождения',
'legalEntityRF,postAddressInfo,mailingAdress':	'Почтовый_адрес_пользователя',
'legalEntityRF,postAddressInfo,mailFacilityName':	'Наименование_объекта_почтовой_связи',
'legalEntityRF,postAddressInfo,postBoxNumber':	'Номер_ячейки_абонементного_почтового_шкафа',
'legalEntityRF,postAddress':	'Почтовый_адрес',
'legalEntityRF,fullName':	'Полное_наименование',
'legalEntityRF,shortName':	'Сокращенное_наименование',
'legalEntityRF,firmName':	'Фирменное_наименование',
'legalEntityRF,fullNameLat':	'Полное_наименование_латинскими_буквами',
'legalEntityRF,taxPayerCode':	'Код_налогоплательщика_в_стране_регистрации',
'legalEntityRF,registerInRFTaxBodies,INN':	'ИНН',
'legalEntityRF,registerInRFTaxBodies,KPP':	'КПП',
'legalEntityRF,registerInRFTaxBodies,registrationDate':	'Дата_постановки_на_учет_в_налоговом_органе',
'legalEntityRF,placeOfStayInRegCountry,country':	'Страна_регистрации',
'legalEntityRF,placeOfStayInRegCountry,address':	'Адрес_места_нахождения_в_стране_регистрации',
'legalEntityRF,placeOfStayInRegCountry,postAddress':	'Почтовый_адрес_в_стране_регистрации',
'legalEntityRF,placeOfStayInRegCountry,contactEMail':	'Электронная_почта',
'legalEntityRF,placeOfStayInRegCountry,contactPhone':	'Телефон_в_стране_регистрации',
'legalEntityRF,placeOfStayInRF,OKTMO':	'ОКТМО',
'legalEntityRF,placeOfStayInRF,address':	'Адрес_места_нахождения',
'legalEntityRF,placeOfStayInRF,postAdressInfo,mailingAdress':	'Почтовый_адрес_пользователя',
'legalEntityRF,placeOfStayInRF,postAdressInfo,mailFacilityName':	'Наименование_объекта_почтовой_связи',
'legalEntityRF,placeOfStayInRF,postAdressInfo,postBoxNumber':	'Номер_ячейки_абонементного_почтового_шкафа',
'legalEntityRF,placeOfStayInRF,postAddressInfo,mailingAdress':	'Почтовый_адрес_пользователя',
'legalEntityRF,placeOfStayInRF,postAddressInfo,mailFacilityName':	'Наименование_объекта_почтовой_связи',
'legalEntityRF,placeOfStayInRF,postAddressInfo,postBoxNumber':	'Номер_ячейки_абонементного_почтового_шкафа',
'legalEntityRF,placeOfStayInRF,contactEMail':	'E_mail_адрес_контактного_лица',
'legalEntityRF,placeOfStayInRF,contactPhone':	'Телефон_контактного_лица',
'legalEntityRF,lastNameLat':	'Фамилия_латинскими_буквами',
'legalEntityRF,firstNameLat':	'Имя_латинскими_буквами',
'legalEntityRF,middleNameLat':	'Отчество_латинскими_буквами',
'legalEntityRF,registerInRFTaxBodies,status':	'Статус_поставщика',
'legalEntityRF,registerInRFTaxBodies,ERSMSPInclusionDate':	'Дата_включения_в_Единый_реестр',
'legalEntityRF,registerInRFTaxBodies,isIP':	'Индивидуальный_предприниматель',
'legalEntityRF,supplierAccountsDetails,supplierAccountDetails,personalAccountNumber':	'Реквизиты_счета_Личный_счет,',
'legalEntityRF,supplierAccountsDetails,supplierAccountDetails,creditOrgName':	'Реквизиты_счета_Наименование_кредитной_организации,',
'legalEntityRF,supplierAccountsDetails,supplierAccountDetails,bankAccountNumber':	'Реквизиты_счета_Номер_счета,',
'legalEntityRF,supplierAccountsDetails,supplierAccountDetails,bik':	'Реквизиты_счета_БИК_банка,',
'legalEntityRF,supplierAccountsDetails,supplierAccountDetails,corrAccountNumber':	'Реквизиты_счета_Корр_счет',
'individualPersonRFIndEntr,EGRULInfo,OGRN':	'ОГРН',
'individualPersonRFIndEntr,EGRULInfo,legalForm':	'Организационно_правовая_форма_организации',
'individualPersonRFIndEntr,EGRULInfo,fullName':	'Полное_наименование',
'individualPersonRFIndEntr,EGRULInfo,shortName':	'Сокращенное_наименование',
'individualPersonRFIndEntr,EGRULInfo,firmName':	'Фирменное_наименование',
'individualPersonRFIndEntr,EGRULInfo,INN':	'ИНН',
'individualPersonRFIndEntr,EGRULInfo,KPP':	'КПП',
'individualPersonRFIndEntr,EGRULInfo,registrationDate':	'Дата_постановки_на_учет_в_налоговом_органе',
'individualPersonRFIndEntr,EGRULInfo,address':	'Адрес_места_нахождения',
'individualPersonRFIndEntr,EGRULInfo,adress':	'Адрес_места_нахождения',
'individualPersonRFIndEntr,isSubdivision':	'Является_филиалом_юридического_лица_РФ',
'individualPersonRFIndEntr,otherInfo,status':	'Статус_поставщика',
'individualPersonRFIndEntr,otherInfo,ERSMSPInclusionDate':	'Дата_включения_в_Единый_реестр',
'individualPersonRFIndEntr,otherInfo,contractPrice':	'Размер_денежных_средств_благотворительность',
'individualPersonRFIndEntr,otherInfo,OKPO':	'ОКПО',
'individualPersonRFIndEntr,otherInfo,OKTMO':	'ОКТМО',
'individualPersonRFIndEntr,otherInfo,personalAccount':	'Номер_лицевого_счета',
'individualPersonRFIndEntr,otherInfo,postAdressInfo,mailingAdress':	'Почтовый_адрес_пользователя',
'individualPersonRFIndEntr,otherInfo,postAdressInfo,mailFacilityName':	'Наименование_объекта_почтовой_связи',
'individualPersonRFIndEntr,otherInfo,postAdressInfo,postBoxNumber':	'Номер_ячейки_абонементного_почтового_шкафа',
'individualPersonRFIndEntr,otherInfo,postAddressInfo,mailingAdress':	'Почтовый_адрес_пользователя',
'individualPersonRFIndEntr,otherInfo,postAddressInfo,mailFacilityName':	'Наименование_объекта_почтовой_связи',
'individualPersonRFIndEntr,otherInfo,postAddressInfo,postBoxNumber':	'Номер_ячейки_абонементного_почтового_шкафа',
'individualPersonRFIndEntr,contactInfo':	'Контактная_информация',
'individualPersonRFIndEntr,contactEMail':	'E_mail_адрес_контактного_лица',
'individualPersonRFIndEntr,contactPhone':	'Телефон_контактного_лица',
'individualPersonRFIndEntr,largestTaxpayerKPP':	'КПП_крупнейшего_налогоплательщика',
'individualPersonRFIndEntr,EGRIPInfo,OGRNIP':	'ОГРНИП',
'individualPersonRFIndEntr,EGRIPInfo,lastName':	'Фамилия',
'individualPersonRFIndEntr,EGRIPInfo,firstName':	'Имя',
'individualPersonRFIndEntr,EGRIPInfo,middleName':	'Отчество',
'individualPersonRFIndEntr,otherInfo,isIP':	'Индивидуальный_предприниматель',
'individualPersonRFIndEntr,lastName':	'Фамилия',
'individualPersonRFIndEntr,firstName':	'Имя',
'individualPersonRFIndEntr,middleName':	'Отчество',
'individualPersonRFIndEntr,INN':	'ИНН',
'individualPersonRFIndEntr,registrationDate':	'Дата_постановки_на_учет_в_налоговом_органе',
'individualPersonRFIndEntr,status':	'Статус_поставщика',
'individualPersonRFIndEntr,ERSMSPInclusionDate':	'Дата_включения_в_Единый_реестр',
'individualPersonRFIndEntr,OKTMO':	'ОКТМО',
'individualPersonRFIndEntr,personalAccount':	'Номер_лицевого_счета',
'individualPersonRFIndEntr,address':	'Адрес_места_нахождения',
'individualPersonRFIndEntr,postAddressInfo,mailingAdress':	'Почтовый_адрес_пользователя',
'individualPersonRFIndEntr,postAddressInfo,mailFacilityName':	'Наименование_объекта_почтовой_связи',
'individualPersonRFIndEntr,postAddressInfo,postBoxNumber':	'Номер_ячейки_абонементного_почтового_шкафа',
'individualPersonRFIndEntr,postAddress':	'Почтовый_адрес',
'individualPersonRFIndEntr,fullName':	'Полное_наименование',
'individualPersonRFIndEntr,shortName':	'Сокращенное_наименование',
'individualPersonRFIndEntr,firmName':	'Фирменное_наименование',
'individualPersonRFIndEntr,fullNameLat':	'Полное_наименование_латинскими_буквами',
'individualPersonRFIndEntr,taxPayerCode':	'Код_налогоплательщика_в_стране_регистрации',
'individualPersonRFIndEntr,registerInRFTaxBodies,INN':	'ИНН',
'individualPersonRFIndEntr,registerInRFTaxBodies,KPP':	'КПП',
'individualPersonRFIndEntr,registerInRFTaxBodies,registrationDate':	'Дата_постановки_на_учет_в_налоговом_органе',
'individualPersonRFIndEntr,placeOfStayInRegCountry,country':	'Страна_регистрации',
'individualPersonRFIndEntr,placeOfStayInRegCountry,address':	'Адрес_места_нахождения_в_стране_регистрации',
'individualPersonRFIndEntr,placeOfStayInRegCountry,postAddress':	'Почтовый_адрес_в_стране_регистрации',
'individualPersonRFIndEntr,placeOfStayInRegCountry,contactEMail':	'Электронная_почта',
'individualPersonRFIndEntr,placeOfStayInRegCountry,contactPhone':	'Телефон_в_стране_регистрации',
'individualPersonRFIndEntr,placeOfStayInRF,OKTMO':	'ОКТМО',
'individualPersonRFIndEntr,placeOfStayInRF,address':	'Адрес_места_нахождения',
'individualPersonRFIndEntr,placeOfStayInRF,postAdressInfo,mailingAdress':	'Почтовый_адрес_пользователя',
'individualPersonRFIndEntr,placeOfStayInRF,postAdressInfo,mailFacilityName':	'Наименование_объекта_почтовой_связи',
'individualPersonRFIndEntr,placeOfStayInRF,postAdressInfo,postBoxNumber':	'Номер_ячейки_абонементного_почтового_шкафа',
'individualPersonRFIndEntr,placeOfStayInRF,postAddressInfo,mailingAdress':	'Почтовый_адрес_пользователя',
'individualPersonRFIndEntr,placeOfStayInRF,postAddressInfo,mailFacilityName':	'Наименование_объекта_почтовой_связи',
'individualPersonRFIndEntr,placeOfStayInRF,postAddressInfo,postBoxNumber':	'Номер_ячейки_абонементного_почтового_шкафа',
'individualPersonRFIndEntr,placeOfStayInRF,contactEMail':	'E_mail_адрес_контактного_лица',
'individualPersonRFIndEntr,placeOfStayInRF,contactPhone':	'Телефон_контактного_лица',
'individualPersonRFIndEntr,lastNameLat':	'Фамилия_латинскими_буквами',
'individualPersonRFIndEntr,firstNameLat':	'Имя_латинскими_буквами',
'individualPersonRFIndEntr,middleNameLat':	'Отчество_латинскими_буквами',
'individualPersonRFIndEntr,registerInRFTaxBodies,status':	'Статус_поставщика',
'individualPersonRFIndEntr,registerInRFTaxBodies,ERSMSPInclusionDate':	'Дата_включения_в_Единый_реестр',
'individualPersonRFIndEntr,registerInRFTaxBodies,isIP':	'Индивидуальный_предприниматель',
'individualPersonRFIndEntr,supplierAccountsDetails,supplierAccountDetails,personalAccountNumber':	'Реквизиты_счета_Личный_счет,',
'individualPersonRFIndEntr,supplierAccountsDetails,supplierAccountDetails,creditOrgName':	'Реквизиты_счета_Наименование_кредитной_организации,',
'individualPersonRFIndEntr,supplierAccountsDetails,supplierAccountDetails,bankAccountNumber':	'Реквизиты_счета_Номер_счета,',
'individualPersonRFIndEntr,supplierAccountsDetails,supplierAccountDetails,bik':	'Реквизиты_счета_БИК_банка,',
'individualPersonRFIndEntr,supplierAccountsDetails,supplierAccountDetails,corrAccountNumber':	'Реквизиты_счета_Корр_счет',
'individualPersonRF,EGRULInfo,OGRN':	'ОГРН',
'individualPersonRF,EGRULInfo,legalForm':	'Организационно_правовая_форма_организации',
'individualPersonRF,EGRULInfo,fullName':	'Полное_наименование',
'individualPersonRF,EGRULInfo,shortName':	'Сокращенное_наименование',
'individualPersonRF,EGRULInfo,firmName':	'Фирменное_наименование',
'individualPersonRF,EGRULInfo,INN':	'ИНН',
'individualPersonRF,EGRULInfo,KPP':	'КПП',
'individualPersonRF,EGRULInfo,registrationDate':	'Дата_постановки_на_учет_в_налоговом_органе',
'individualPersonRF,EGRULInfo,address':	'Адрес_места_нахождения',
'individualPersonRF,EGRULInfo,adress':	'Адрес_места_нахождения',
'individualPersonRF,isSubdivision':	'Является_филиалом_юридического_лица_РФ',
'individualPersonRF,otherInfo,status':	'Статус_поставщика',
'individualPersonRF,otherInfo,ERSMSPInclusionDate':	'Дата_включения_в_Единый_реестр',
'individualPersonRF,otherInfo,contractPrice':	'Размер_денежных_средств_благотворительность',
'individualPersonRF,otherInfo,OKPO':	'ОКПО',
'individualPersonRF,otherInfo,OKTMO':	'ОКТМО',
'individualPersonRF,otherInfo,personalAccount':	'Номер_лицевого_счета',
'individualPersonRF,otherInfo,postAdressInfo,mailingAdress':	'Почтовый_адрес_пользователя',
'individualPersonRF,otherInfo,postAdressInfo,mailFacilityName':	'Наименование_объекта_почтовой_связи',
'individualPersonRF,otherInfo,postAdressInfo,postBoxNumber':	'Номер_ячейки_абонементного_почтового_шкафа',
'individualPersonRF,otherInfo,postAddressInfo,mailingAdress':	'Почтовый_адрес_пользователя',
'individualPersonRF,otherInfo,postAddressInfo,mailFacilityName':	'Наименование_объекта_почтовой_связи',
'individualPersonRF,otherInfo,postAddressInfo,postBoxNumber':	'Номер_ячейки_абонементного_почтового_шкафа',
'individualPersonRF,contactInfo':	'Контактная_информация',
'individualPersonRF,contactEMail':	'E_mail_адрес_контактного_лица',
'individualPersonRF,contactPhone':	'Телефон_контактного_лица',
'individualPersonRF,largestTaxpayerKPP':	'КПП_крупнейшего_налогоплательщика',
'individualPersonRF,EGRIPInfo,OGRNIP':	'ОГРНИП',
'individualPersonRF,EGRIPInfo,lastName':	'Фамилия',
'individualPersonRF,EGRIPInfo,firstName':	'Имя',
'individualPersonRF,EGRIPInfo,middleName':	'Отчество',
'individualPersonRF,otherInfo,isIP':	'Индивидуальный_предприниматель',
'individualPersonRF,lastName':	'Фамилия',
'individualPersonRF,firstName':	'Имя',
'individualPersonRF,middleName':	'Отчество',
'individualPersonRF,INN':	'ИНН',
'individualPersonRF,registrationDate':	'Дата_постановки_на_учет_в_налоговом_органе',
'individualPersonRF,status':	'Статус_поставщика',
'individualPersonRF,ERSMSPInclusionDate':	'Дата_включения_в_Единый_реестр',
'individualPersonRF,OKTMO':	'ОКТМО',
'individualPersonRF,personalAccount':	'Номер_лицевого_счета',
'individualPersonRF,address':	'Адрес_места_нахождения',
'individualPersonRF,postAddressInfo,mailingAdress':	'Почтовый_адрес_пользователя',
'individualPersonRF,postAddressInfo,mailFacilityName':	'Наименование_объекта_почтовой_связи',
'individualPersonRF,postAddressInfo,postBoxNumber':	'Номер_ячейки_абонементного_почтового_шкафа',
'individualPersonRF,postAddress':	'Почтовый_адрес',
'individualPersonRF,fullName':	'Полное_наименование',
'individualPersonRF,shortName':	'Сокращенное_наименование',
'individualPersonRF,firmName':	'Фирменное_наименование',
'individualPersonRF,fullNameLat':	'Полное_наименование_латинскими_буквами',
'individualPersonRF,taxPayerCode':	'Код_налогоплательщика_в_стране_регистрации',
'individualPersonRF,registerInRFTaxBodies,INN':	'ИНН',
'individualPersonRF,registerInRFTaxBodies,KPP':	'КПП',
'individualPersonRF,registerInRFTaxBodies,registrationDate':	'Дата_постановки_на_учет_в_налоговом_органе',
'individualPersonRF,placeOfStayInRegCountry,country':	'Страна_регистрации',
'individualPersonRF,placeOfStayInRegCountry,address':	'Адрес_места_нахождения_в_стране_регистрации',
'individualPersonRF,placeOfStayInRegCountry,postAddress':	'Почтовый_адрес_в_стране_регистрации',
'individualPersonRF,placeOfStayInRegCountry,contactEMail':	'Электронная_почта',
'individualPersonRF,placeOfStayInRegCountry,contactPhone':	'Телефон_в_стране_регистрации',
'individualPersonRF,placeOfStayInRF,OKTMO':	'ОКТМО',
'individualPersonRF,placeOfStayInRF,address':	'Адрес_места_нахождения',
'individualPersonRF,placeOfStayInRF,postAdressInfo,mailingAdress':	'Почтовый_адрес_пользователя',
'individualPersonRF,placeOfStayInRF,postAdressInfo,mailFacilityName':	'Наименование_объекта_почтовой_связи',
'individualPersonRF,placeOfStayInRF,postAdressInfo,postBoxNumber':	'Номер_ячейки_абонементного_почтового_шкафа',
'individualPersonRF,placeOfStayInRF,postAddressInfo,mailingAdress':	'Почтовый_адрес_пользователя',
'individualPersonRF,placeOfStayInRF,postAddressInfo,mailFacilityName':	'Наименование_объекта_почтовой_связи',
'individualPersonRF,placeOfStayInRF,postAddressInfo,postBoxNumber':	'Номер_ячейки_абонементного_почтового_шкафа',
'individualPersonRF,placeOfStayInRF,contactEMail':	'E_mail_адрес_контактного_лица',
'individualPersonRF,placeOfStayInRF,contactPhone':	'Телефон_контактного_лица',
'individualPersonRF,lastNameLat':	'Фамилия_латинскими_буквами',
'individualPersonRF,firstNameLat':	'Имя_латинскими_буквами',
'individualPersonRF,middleNameLat':	'Отчество_латинскими_буквами',
'individualPersonRF,registerInRFTaxBodies,status':	'Статус_поставщика',
'individualPersonRF,registerInRFTaxBodies,ERSMSPInclusionDate':	'Дата_включения_в_Единый_реестр',
'individualPersonRF,registerInRFTaxBodies,isIP':	'Индивидуальный_предприниматель',
'individualPersonRF,supplierAccountsDetails,supplierAccountDetails,personalAccountNumber':	'Реквизиты_счета_Личный_счет,',
'individualPersonRF,supplierAccountsDetails,supplierAccountDetails,creditOrgName':	'Реквизиты_счета_Наименование_кредитной_организации,',
'individualPersonRF,supplierAccountsDetails,supplierAccountDetails,bankAccountNumber':	'Реквизиты_счета_Номер_счета,',
'individualPersonRF,supplierAccountsDetails,supplierAccountDetails,bik':	'Реквизиты_счета_БИК_банка,',
'individualPersonRF,supplierAccountsDetails,supplierAccountDetails,corrAccountNumber':	'Реквизиты_счета_Корр_счет',
'individualPersonRFIndEntrisCulture,EGRULInfo,OGRN':	'ОГРН',
'individualPersonRFIndEntrisCulture,EGRULInfo,legalForm':	'Организационно_правовая_форма_организации',
'individualPersonRFIndEntrisCulture,EGRULInfo,fullName':	'Полное_наименование',
'individualPersonRFIndEntrisCulture,EGRULInfo,shortName':	'Сокращенное_наименование',
'individualPersonRFIndEntrisCulture,EGRULInfo,firmName':	'Фирменное_наименование',
'individualPersonRFIndEntrisCulture,EGRULInfo,INN':	'ИНН',
'individualPersonRFIndEntrisCulture,EGRULInfo,KPP':	'КПП',
'individualPersonRFIndEntrisCulture,EGRULInfo,registrationDate':	'Дата_постановки_на_учет_в_налоговом_органе',
'individualPersonRFIndEntrisCulture,EGRULInfo,address':	'Адрес_места_нахождения',
'individualPersonRFIndEntrisCulture,EGRULInfo,adress':	'Адрес_места_нахождения',
'individualPersonRFIndEntrisCulture,isSubdivision':	'Является_филиалом_юридического_лица_РФ',
'individualPersonRFIndEntrisCulture,otherInfo,status':	'Статус_поставщика',
'individualPersonRFIndEntrisCulture,otherInfo,ERSMSPInclusionDate':	'Дата_включения_в_Единый_реестр',
'individualPersonRFIndEntrisCulture,otherInfo,contractPrice':	'Размер_денежных_средств_благотворительность',
'individualPersonRFIndEntrisCulture,otherInfo,OKPO':	'ОКПО',
'individualPersonRFIndEntrisCulture,otherInfo,OKTMO':	'ОКТМО',
'individualPersonRFIndEntrisCulture,otherInfo,personalAccount':	'Номер_лицевого_счета',
'individualPersonRFIndEntrisCulture,otherInfo,postAdressInfo,mailingAdress':	'Почтовый_адрес_пользователя',
'individualPersonRFIndEntrisCulture,otherInfo,postAdressInfo,mailFacilityName':	'Наименование_объекта_почтовой_связи',
'individualPersonRFIndEntrisCulture,otherInfo,postAdressInfo,postBoxNumber':	'Номер_ячейки_абонементного_почтового_шкафа',
'individualPersonRFIndEntrisCulture,otherInfo,postAddressInfo,mailingAdress':	'Почтовый_адрес_пользователя',
'individualPersonRFIndEntrisCulture,otherInfo,postAddressInfo,mailFacilityName':	'Наименование_объекта_почтовой_связи',
'individualPersonRFIndEntrisCulture,otherInfo,postAddressInfo,postBoxNumber':	'Номер_ячейки_абонементного_почтового_шкафа',
'individualPersonRFIndEntrisCulture,contactInfo':	'Контактная_информация',
'individualPersonRFIndEntrisCulture,contactEMail':	'E_mail_адрес_контактного_лица',
'individualPersonRFIndEntrisCulture,contactPhone':	'Телефон_контактного_лица',
'individualPersonRFIndEntrisCulture,largestTaxpayerKPP':	'КПП_крупнейшего_налогоплательщика',
'individualPersonRFIndEntrisCulture,EGRIPInfo,OGRNIP':	'ОГРНИП',
'individualPersonRFIndEntrisCulture,EGRIPInfo,lastName':	'Фамилия',
'individualPersonRFIndEntrisCulture,EGRIPInfo,firstName':	'Имя',
'individualPersonRFIndEntrisCulture,EGRIPInfo,middleName':	'Отчество',
'individualPersonRFIndEntrisCulture,otherInfo,isIP':	'Индивидуальный_предприниматель',
'individualPersonRFIndEntrisCulture,lastName':	'Фамилия',
'individualPersonRFIndEntrisCulture,firstName':	'Имя',
'individualPersonRFIndEntrisCulture,middleName':	'Отчество',
'individualPersonRFIndEntrisCulture,INN':	'ИНН',
'individualPersonRFIndEntrisCulture,registrationDate':	'Дата_постановки_на_учет_в_налоговом_органе',
'individualPersonRFIndEntrisCulture,status':	'Статус_поставщика',
'individualPersonRFIndEntrisCulture,ERSMSPInclusionDate':	'Дата_включения_в_Единый_реестр',
'individualPersonRFIndEntrisCulture,OKTMO':	'ОКТМО',
'individualPersonRFIndEntrisCulture,personalAccount':	'Номер_лицевого_счета',
'individualPersonRFIndEntrisCulture,address':	'Адрес_места_нахождения',
'individualPersonRFIndEntrisCulture,postAddressInfo,mailingAdress':	'Почтовый_адрес_пользователя',
'individualPersonRFIndEntrisCulture,postAddressInfo,mailFacilityName':	'Наименование_объекта_почтовой_связи',
'individualPersonRFIndEntrisCulture,postAddressInfo,postBoxNumber':	'Номер_ячейки_абонементного_почтового_шкафа',
'individualPersonRFIndEntrisCulture,postAddress':	'Почтовый_адрес',
'individualPersonRFIndEntrisCulture,fullName':	'Полное_наименование',
'individualPersonRFIndEntrisCulture,shortName':	'Сокращенное_наименование',
'individualPersonRFIndEntrisCulture,firmName':	'Фирменное_наименование',
'individualPersonRFIndEntrisCulture,fullNameLat':	'Полное_наименование_латинскими_буквами',
'individualPersonRFIndEntrisCulture,taxPayerCode':	'Код_налогоплательщика_в_стране_регистрации',
'individualPersonRFIndEntrisCulture,registerInRFTaxBodies,INN':	'ИНН',
'individualPersonRFIndEntrisCulture,registerInRFTaxBodies,KPP':	'КПП',
'individualPersonRFIndEntrisCulture,registerInRFTaxBodies,registrationDate':	'Дата_постановки_на_учет_в_налоговом_органе',
'individualPersonRFIndEntrisCulture,placeOfStayInRegCountry,country':	'Страна_регистрации',
'individualPersonRFIndEntrisCulture,placeOfStayInRegCountry,address':	'Адрес_места_нахождения_в_стране_регистрации',
'individualPersonRFIndEntrisCulture,placeOfStayInRegCountry,postAddress':	'Почтовый_адрес_в_стране_регистрации',
'individualPersonRFIndEntrisCulture,placeOfStayInRegCountry,contactEMail':	'Электронная_почта',
'individualPersonRFIndEntrisCulture,placeOfStayInRegCountry,contactPhone':	'Телефон_в_стране_регистрации',
'individualPersonRFIndEntrisCulture,placeOfStayInRF,OKTMO':	'ОКТМО',
'individualPersonRFIndEntrisCulture,placeOfStayInRF,address':	'Адрес_места_нахождения',
'individualPersonRFIndEntrisCulture,placeOfStayInRF,postAdressInfo,mailingAdress':	'Почтовый_адрес_пользователя',
'individualPersonRFIndEntrisCulture,placeOfStayInRF,postAdressInfo,mailFacilityName':	'Наименование_объекта_почтовой_связи',
'individualPersonRFIndEntrisCulture,placeOfStayInRF,postAdressInfo,postBoxNumber':	'Номер_ячейки_абонементного_почтового_шкафа',
'individualPersonRFIndEntrisCulture,placeOfStayInRF,postAddressInfo,mailingAdress':	'Почтовый_адрес_пользователя',
'individualPersonRFIndEntrisCulture,placeOfStayInRF,postAddressInfo,mailFacilityName':	'Наименование_объекта_почтовой_связи',
'individualPersonRFIndEntrisCulture,placeOfStayInRF,postAddressInfo,postBoxNumber':	'Номер_ячейки_абонементного_почтового_шкафа',
'individualPersonRFIndEntrisCulture,placeOfStayInRF,contactEMail':	'E_mail_адрес_контактного_лица',
'individualPersonRFIndEntrisCulture,placeOfStayInRF,contactPhone':	'Телефон_контактного_лица',
'individualPersonRFIndEntrisCulture,lastNameLat':	'Фамилия_латинскими_буквами',
'individualPersonRFIndEntrisCulture,firstNameLat':	'Имя_латинскими_буквами',
'individualPersonRFIndEntrisCulture,middleNameLat':	'Отчество_латинскими_буквами',
'individualPersonRFIndEntrisCulture,registerInRFTaxBodies,status':	'Статус_поставщика',
'individualPersonRFIndEntrisCulture,registerInRFTaxBodies,ERSMSPInclusionDate':	'Дата_включения_в_Единый_реестр',
'individualPersonRFIndEntrisCulture,registerInRFTaxBodies,isIP':	'Индивидуальный_предприниматель',
'individualPersonRFIndEntrisCulture,supplierAccountsDetails,supplierAccountDetails,personalAccountNumber':	'Реквизиты_счета_Личный_счет,',
'individualPersonRFIndEntrisCulture,supplierAccountsDetails,supplierAccountDetails,creditOrgName':	'Реквизиты_счета_Наименование_кредитной_организации,',
'individualPersonRFIndEntrisCulture,supplierAccountsDetails,supplierAccountDetails,bankAccountNumber':	'Реквизиты_счета_Номер_счета,',
'individualPersonRFIndEntrisCulture,supplierAccountsDetails,supplierAccountDetails,bik':	'Реквизиты_счета_БИК_банка,',
'individualPersonRFIndEntrisCulture,supplierAccountsDetails,supplierAccountDetails,corrAccountNumber':	'Реквизиты_счета_Корр_счет',
'individualPersonRFisCulture,EGRULInfo,OGRN':	'ОГРН',
'individualPersonRFisCulture,EGRULInfo,legalForm':	'Организационно_правовая_форма_организации',
'individualPersonRFisCulture,EGRULInfo,fullName':	'Полное_наименование',
'individualPersonRFisCulture,EGRULInfo,shortName':	'Сокращенное_наименование',
'individualPersonRFisCulture,EGRULInfo,firmName':	'Фирменное_наименование',
'individualPersonRFisCulture,EGRULInfo,INN':	'ИНН',
'individualPersonRFisCulture,EGRULInfo,KPP':	'КПП',
'individualPersonRFisCulture,EGRULInfo,registrationDate':	'Дата_постановки_на_учет_в_налоговом_органе',
'individualPersonRFisCulture,EGRULInfo,address':	'Адрес_места_нахождения',
'individualPersonRFisCulture,EGRULInfo,adress':	'Адрес_места_нахождения',
'individualPersonRFisCulture,isSubdivision':	'Является_филиалом_юридического_лица_РФ',
'individualPersonRFisCulture,otherInfo,status':	'Статус_поставщика',
'individualPersonRFisCulture,otherInfo,ERSMSPInclusionDate':	'Дата_включения_в_Единый_реестр',
'individualPersonRFisCulture,otherInfo,contractPrice':	'Размер_денежных_средств_благотворительность',
'individualPersonRFisCulture,otherInfo,OKPO':	'ОКПО',
'individualPersonRFisCulture,otherInfo,OKTMO':	'ОКТМО',
'individualPersonRFisCulture,otherInfo,personalAccount':	'Номер_лицевого_счета',
'individualPersonRFisCulture,otherInfo,postAdressInfo,mailingAdress':	'Почтовый_адрес_пользователя',
'individualPersonRFisCulture,otherInfo,postAdressInfo,mailFacilityName':	'Наименование_объекта_почтовой_связи',
'individualPersonRFisCulture,otherInfo,postAdressInfo,postBoxNumber':	'Номер_ячейки_абонементного_почтового_шкафа',
'individualPersonRFisCulture,otherInfo,postAddressInfo,mailingAdress':	'Почтовый_адрес_пользователя',
'individualPersonRFisCulture,otherInfo,postAddressInfo,mailFacilityName':	'Наименование_объекта_почтовой_связи',
'individualPersonRFisCulture,otherInfo,postAddressInfo,postBoxNumber':	'Номер_ячейки_абонементного_почтового_шкафа',
'individualPersonRFisCulture,contactInfo':	'Контактная_информация',
'individualPersonRFisCulture,contactEMail':	'E_mail_адрес_контактного_лица',
'individualPersonRFisCulture,contactPhone':	'Телефон_контактного_лица',
'individualPersonRFisCulture,largestTaxpayerKPP':	'КПП_крупнейшего_налогоплательщика',
'individualPersonRFisCulture,EGRIPInfo,OGRNIP':	'ОГРНИП',
'individualPersonRFisCulture,EGRIPInfo,lastName':	'Фамилия',
'individualPersonRFisCulture,EGRIPInfo,firstName':	'Имя',
'individualPersonRFisCulture,EGRIPInfo,middleName':	'Отчество',
'individualPersonRFisCulture,otherInfo,isIP':	'Индивидуальный_предприниматель',
'individualPersonRFisCulture,lastName':	'Фамилия',
'individualPersonRFisCulture,firstName':	'Имя',
'individualPersonRFisCulture,middleName':	'Отчество',
'individualPersonRFisCulture,INN':	'ИНН',
'individualPersonRFisCulture,registrationDate':	'Дата_постановки_на_учет_в_налоговом_органе',
'individualPersonRFisCulture,status':	'Статус_поставщика',
'individualPersonRFisCulture,ERSMSPInclusionDate':	'Дата_включения_в_Единый_реестр',
'individualPersonRFisCulture,OKTMO':	'ОКТМО',
'individualPersonRFisCulture,personalAccount':	'Номер_лицевого_счета',
'individualPersonRFisCulture,address':	'Адрес_места_нахождения',
'individualPersonRFisCulture,postAddressInfo,mailingAdress':	'Почтовый_адрес_пользователя',
'individualPersonRFisCulture,postAddressInfo,mailFacilityName':	'Наименование_объекта_почтовой_связи',
'individualPersonRFisCulture,postAddressInfo,postBoxNumber':	'Номер_ячейки_абонементного_почтового_шкафа',
'individualPersonRFisCulture,postAddress':	'Почтовый_адрес',
'individualPersonRFisCulture,fullName':	'Полное_наименование',
'individualPersonRFisCulture,shortName':	'Сокращенное_наименование',
'individualPersonRFisCulture,firmName':	'Фирменное_наименование',
'individualPersonRFisCulture,fullNameLat':	'Полное_наименование_латинскими_буквами',
'individualPersonRFisCulture,taxPayerCode':	'Код_налогоплательщика_в_стране_регистрации',
'individualPersonRFisCulture,registerInRFTaxBodies,INN':	'ИНН',
'individualPersonRFisCulture,registerInRFTaxBodies,KPP':	'КПП',
'individualPersonRFisCulture,registerInRFTaxBodies,registrationDate':	'Дата_постановки_на_учет_в_налоговом_органе',
'individualPersonRFisCulture,placeOfStayInRegCountry,country':	'Страна_регистрации',
'individualPersonRFisCulture,placeOfStayInRegCountry,address':	'Адрес_места_нахождения_в_стране_регистрации',
'individualPersonRFisCulture,placeOfStayInRegCountry,postAddress':	'Почтовый_адрес_в_стране_регистрации',
'individualPersonRFisCulture,placeOfStayInRegCountry,contactEMail':	'Электронная_почта',
'individualPersonRFisCulture,placeOfStayInRegCountry,contactPhone':	'Телефон_в_стране_регистрации',
'individualPersonRFisCulture,placeOfStayInRF,OKTMO':	'ОКТМО',
'individualPersonRFisCulture,placeOfStayInRF,address':	'Адрес_места_нахождения',
'individualPersonRFisCulture,placeOfStayInRF,postAdressInfo,mailingAdress':	'Почтовый_адрес_пользователя',
'individualPersonRFisCulture,placeOfStayInRF,postAdressInfo,mailFacilityName':	'Наименование_объекта_почтовой_связи',
'individualPersonRFisCulture,placeOfStayInRF,postAdressInfo,postBoxNumber':	'Номер_ячейки_абонементного_почтового_шкафа',
'individualPersonRFisCulture,placeOfStayInRF,postAddressInfo,mailingAdress':	'Почтовый_адрес_пользователя',
'individualPersonRFisCulture,placeOfStayInRF,postAddressInfo,mailFacilityName':	'Наименование_объекта_почтовой_связи',
'individualPersonRFisCulture,placeOfStayInRF,postAddressInfo,postBoxNumber':	'Номер_ячейки_абонементного_почтового_шкафа',
'individualPersonRFisCulture,placeOfStayInRF,contactEMail':	'E_mail_адрес_контактного_лица',
'individualPersonRFisCulture,placeOfStayInRF,contactPhone':	'Телефон_контактного_лица',
'individualPersonRFisCulture,lastNameLat':	'Фамилия_латинскими_буквами',
'individualPersonRFisCulture,firstNameLat':	'Имя_латинскими_буквами',
'individualPersonRFisCulture,middleNameLat':	'Отчество_латинскими_буквами',
'individualPersonRFisCulture,registerInRFTaxBodies,status':	'Статус_поставщика',
'individualPersonRFisCulture,registerInRFTaxBodies,ERSMSPInclusionDate':	'Дата_включения_в_Единый_реестр',
'individualPersonRFisCulture,registerInRFTaxBodies,isIP':	'Индивидуальный_предприниматель',
'individualPersonRFisCulture,supplierAccountsDetails,supplierAccountDetails,personalAccountNumber':	'Реквизиты_счета_Личный_счет,',
'individualPersonRFisCulture,supplierAccountsDetails,supplierAccountDetails,creditOrgName':	'Реквизиты_счета_Наименование_кредитной_организации,',
'individualPersonRFisCulture,supplierAccountsDetails,supplierAccountDetails,bankAccountNumber':	'Реквизиты_счета_Номер_счета,',
'individualPersonRFisCulture,supplierAccountsDetails,supplierAccountDetails,bik':	'Реквизиты_счета_БИК_банка,',
'individualPersonRFisCulture,supplierAccountsDetails,supplierAccountDetails,corrAccountNumber':	'Реквизиты_счета_Корр_счет',
'legalEntityForeignState,EGRULInfo,OGRN':	'ОГРН',
'legalEntityForeignState,EGRULInfo,legalForm':	'Организационно_правовая_форма_организации',
'legalEntityForeignState,EGRULInfo,fullName':	'Полное_наименование',
'legalEntityForeignState,EGRULInfo,shortName':	'Сокращенное_наименование',
'legalEntityForeignState,EGRULInfo,firmName':	'Фирменное_наименование',
'legalEntityForeignState,EGRULInfo,INN':	'ИНН',
'legalEntityForeignState,EGRULInfo,KPP':	'КПП',
'legalEntityForeignState,EGRULInfo,registrationDate':	'Дата_постановки_на_учет_в_налоговом_органе',
'legalEntityForeignState,EGRULInfo,address':	'Адрес_места_нахождения',
'legalEntityForeignState,EGRULInfo,adress':	'Адрес_места_нахождения',
'legalEntityForeignState,isSubdivision':	'Является_филиалом_юридического_лица_РФ',
'legalEntityForeignState,otherInfo,status':	'Статус_поставщика',
'legalEntityForeignState,otherInfo,ERSMSPInclusionDate':	'Дата_включения_в_Единый_реестр',
'legalEntityForeignState,otherInfo,contractPrice':	'Размер_денежных_средств_благотворительность',
'legalEntityForeignState,otherInfo,OKPO':	'ОКПО',
'legalEntityForeignState,otherInfo,OKTMO':	'ОКТМО',
'legalEntityForeignState,otherInfo,personalAccount':	'Номер_лицевого_счета',
'legalEntityForeignState,otherInfo,postAdressInfo,mailingAdress':	'Почтовый_адрес_пользователя',
'legalEntityForeignState,otherInfo,postAdressInfo,mailFacilityName':	'Наименование_объекта_почтовой_связи',
'legalEntityForeignState,otherInfo,postAdressInfo,postBoxNumber':	'Номер_ячейки_абонементного_почтового_шкафа',
'legalEntityForeignState,otherInfo,postAddressInfo,mailingAdress':	'Почтовый_адрес_пользователя',
'legalEntityForeignState,otherInfo,postAddressInfo,mailFacilityName':	'Наименование_объекта_почтовой_связи',
'legalEntityForeignState,otherInfo,postAddressInfo,postBoxNumber':	'Номер_ячейки_абонементного_почтового_шкафа',
'legalEntityForeignState,contactInfo':	'Контактная_информация',
'legalEntityForeignState,contactEMail':	'E_mail_адрес_контактного_лица',
'legalEntityForeignState,contactPhone':	'Телефон_контактного_лица',
'legalEntityForeignState,largestTaxpayerKPP':	'КПП_крупнейшего_налогоплательщика',
'legalEntityForeignState,EGRIPInfo,OGRNIP':	'ОГРНИП',
'legalEntityForeignState,EGRIPInfo,lastName':	'Фамилия',
'legalEntityForeignState,EGRIPInfo,firstName':	'Имя',
'legalEntityForeignState,EGRIPInfo,middleName':	'Отчество',
'legalEntityForeignState,otherInfo,isIP':	'Индивидуальный_предприниматель',
'legalEntityForeignState,lastName':	'Фамилия',
'legalEntityForeignState,firstName':	'Имя',
'legalEntityForeignState,middleName':	'Отчество',
'legalEntityForeignState,INN':	'ИНН',
'legalEntityForeignState,registrationDate':	'Дата_постановки_на_учет_в_налоговом_органе',
'legalEntityForeignState,status':	'Статус_поставщика',
'legalEntityForeignState,ERSMSPInclusionDate':	'Дата_включения_в_Единый_реестр',
'legalEntityForeignState,OKTMO':	'ОКТМО',
'legalEntityForeignState,personalAccount':	'Номер_лицевого_счета',
'legalEntityForeignState,address':	'Адрес_места_нахождения',
'legalEntityForeignState,postAddressInfo,mailingAdress':	'Почтовый_адрес_пользователя',
'legalEntityForeignState,postAddressInfo,mailFacilityName':	'Наименование_объекта_почтовой_связи',
'legalEntityForeignState,postAddressInfo,postBoxNumber':	'Номер_ячейки_абонементного_почтового_шкафа',
'legalEntityForeignState,postAddress':	'Почтовый_адрес',
'legalEntityForeignState,fullName':	'Полное_наименование',
'legalEntityForeignState,shortName':	'Сокращенное_наименование',
'legalEntityForeignState,firmName':	'Фирменное_наименование',
'legalEntityForeignState,fullNameLat':	'Полное_наименование_латинскими_буквами',
'legalEntityForeignState,taxPayerCode':	'Код_налогоплательщика_в_стране_регистрации',
'legalEntityForeignState,registerInRFTaxBodies,INN':	'ИНН',
'legalEntityForeignState,registerInRFTaxBodies,KPP':	'КПП',
'legalEntityForeignState,registerInRFTaxBodies,registrationDate':	'Дата_постановки_на_учет_в_налоговом_органе',
'legalEntityForeignState,placeOfStayInRegCountry,country':	'Страна_регистрации',
'legalEntityForeignState,placeOfStayInRegCountry,address':	'Адрес_места_нахождения_в_стране_регистрации',
'legalEntityForeignState,placeOfStayInRegCountry,postAddress':	'Почтовый_адрес_в_стране_регистрации',
'legalEntityForeignState,placeOfStayInRegCountry,contactEMail':	'Электронная_почта',
'legalEntityForeignState,placeOfStayInRegCountry,contactPhone':	'Телефон_в_стране_регистрации',
'legalEntityForeignState,placeOfStayInRF,OKTMO':	'ОКТМО',
'legalEntityForeignState,placeOfStayInRF,address':	'Адрес_места_нахождения',
'legalEntityForeignState,placeOfStayInRF,postAdressInfo,mailingAdress':	'Почтовый_адрес_пользователя',
'legalEntityForeignState,placeOfStayInRF,postAdressInfo,mailFacilityName':	'Наименование_объекта_почтовой_связи',
'legalEntityForeignState,placeOfStayInRF,postAdressInfo,postBoxNumber':	'Номер_ячейки_абонементного_почтового_шкафа',
'legalEntityForeignState,placeOfStayInRF,postAddressInfo,mailingAdress':	'Почтовый_адрес_пользователя',
'legalEntityForeignState,placeOfStayInRF,postAddressInfo,mailFacilityName':	'Наименование_объекта_почтовой_связи',
'legalEntityForeignState,placeOfStayInRF,postAddressInfo,postBoxNumber':	'Номер_ячейки_абонементного_почтового_шкафа',
'legalEntityForeignState,placeOfStayInRF,contactEMail':	'E_mail_адрес_контактного_лица',
'legalEntityForeignState,placeOfStayInRF,contactPhone':	'Телефон_контактного_лица',
'legalEntityForeignState,lastNameLat':	'Фамилия_латинскими_буквами',
'legalEntityForeignState,firstNameLat':	'Имя_латинскими_буквами',
'legalEntityForeignState,middleNameLat':	'Отчество_латинскими_буквами',
'legalEntityForeignState,registerInRFTaxBodies,status':	'Статус_поставщика',
'legalEntityForeignState,registerInRFTaxBodies,ERSMSPInclusionDate':	'Дата_включения_в_Единый_реестр',
'legalEntityForeignState,registerInRFTaxBodies,isIP':	'Индивидуальный_предприниматель',
'legalEntityForeignState,supplierAccountsDetails,supplierAccountDetails,personalAccountNumber':	'Реквизиты_счета_Личный_счет,',
'legalEntityForeignState,supplierAccountsDetails,supplierAccountDetails,creditOrgName':	'Реквизиты_счета_Наименование_кредитной_организации,',
'legalEntityForeignState,supplierAccountsDetails,supplierAccountDetails,bankAccountNumber':	'Реквизиты_счета_Номер_счета,',
'legalEntityForeignState,supplierAccountsDetails,supplierAccountDetails,bik':	'Реквизиты_счета_БИК_банка,',
'legalEntityForeignState,supplierAccountsDetails,supplierAccountDetails,corrAccountNumber':	'Реквизиты_счета_Корр_счет',
'individualPersonForeignState,EGRULInfo,OGRN':	'ОГРН',
'individualPersonForeignState,EGRULInfo,legalForm':	'Организационно_правовая_форма_организации',
'individualPersonForeignState,EGRULInfo,fullName':	'Полное_наименование',
'individualPersonForeignState,EGRULInfo,shortName':	'Сокращенное_наименование',
'individualPersonForeignState,EGRULInfo,firmName':	'Фирменное_наименование',
'individualPersonForeignState,EGRULInfo,INN':	'ИНН',
'individualPersonForeignState,EGRULInfo,KPP':	'КПП',
'individualPersonForeignState,EGRULInfo,registrationDate':	'Дата_постановки_на_учет_в_налоговом_органе',
'individualPersonForeignState,EGRULInfo,address':	'Адрес_места_нахождения',
'individualPersonForeignState,EGRULInfo,adress':	'Адрес_места_нахождения',
'individualPersonForeignState,isSubdivision':	'Является_филиалом_юридического_лица_РФ',
'individualPersonForeignState,otherInfo,status':	'Статус_поставщика',
'individualPersonForeignState,otherInfo,ERSMSPInclusionDate':	'Дата_включения_в_Единый_реестр',
'individualPersonForeignState,otherInfo,contractPrice':	'Размер_денежных_средств_благотворительность',
'individualPersonForeignState,otherInfo,OKPO':	'ОКПО',
'individualPersonForeignState,otherInfo,OKTMO':	'ОКТМО',
'individualPersonForeignState,otherInfo,personalAccount':	'Номер_лицевого_счета',
'individualPersonForeignState,otherInfo,postAdressInfo,mailingAdress':	'Почтовый_адрес_пользователя',
'individualPersonForeignState,otherInfo,postAdressInfo,mailFacilityName':	'Наименование_объекта_почтовой_связи',
'individualPersonForeignState,otherInfo,postAdressInfo,postBoxNumber':	'Номер_ячейки_абонементного_почтового_шкафа',
'individualPersonForeignState,otherInfo,postAddressInfo,mailingAdress':	'Почтовый_адрес_пользователя',
'individualPersonForeignState,otherInfo,postAddressInfo,mailFacilityName':	'Наименование_объекта_почтовой_связи',
'individualPersonForeignState,otherInfo,postAddressInfo,postBoxNumber':	'Номер_ячейки_абонементного_почтового_шкафа',
'individualPersonForeignState,contactInfo':	'Контактная_информация',
'individualPersonForeignState,contactEMail':	'E_mail_адрес_контактного_лица',
'individualPersonForeignState,contactPhone':	'Телефон_контактного_лица',
'individualPersonForeignState,largestTaxpayerKPP':	'КПП_крупнейшего_налогоплательщика',
'individualPersonForeignState,EGRIPInfo,OGRNIP':	'ОГРНИП',
'individualPersonForeignState,EGRIPInfo,lastName':	'Фамилия',
'individualPersonForeignState,EGRIPInfo,firstName':	'Имя',
'individualPersonForeignState,EGRIPInfo,middleName':	'Отчество',
'individualPersonForeignState,otherInfo,isIP':	'Индивидуальный_предприниматель',
'individualPersonForeignState,lastName':	'Фамилия',
'individualPersonForeignState,firstName':	'Имя',
'individualPersonForeignState,middleName':	'Отчество',
'individualPersonForeignState,INN':	'ИНН',
'individualPersonForeignState,registrationDate':	'Дата_постановки_на_учет_в_налоговом_органе',
'individualPersonForeignState,status':	'Статус_поставщика',
'individualPersonForeignState,ERSMSPInclusionDate':	'Дата_включения_в_Единый_реестр',
'individualPersonForeignState,OKTMO':	'ОКТМО',
'individualPersonForeignState,personalAccount':	'Номер_лицевого_счета',
'individualPersonForeignState,address':	'Адрес_места_нахождения',
'individualPersonForeignState,postAddressInfo,mailingAdress':	'Почтовый_адрес_пользователя',
'individualPersonForeignState,postAddressInfo,mailFacilityName':	'Наименование_объекта_почтовой_связи',
'individualPersonForeignState,postAddressInfo,postBoxNumber':	'Номер_ячейки_абонементного_почтового_шкафа',
'individualPersonForeignState,postAddress':	'Почтовый_адрес',
'individualPersonForeignState,fullName':	'Полное_наименование',
'individualPersonForeignState,shortName':	'Сокращенное_наименование',
'individualPersonForeignState,firmName':	'Фирменное_наименование',
'individualPersonForeignState,fullNameLat':	'Полное_наименование_латинскими_буквами',
'individualPersonForeignState,taxPayerCode':	'Код_налогоплательщика_в_стране_регистрации',
'individualPersonForeignState,registerInRFTaxBodies,INN':	'ИНН',
'individualPersonForeignState,registerInRFTaxBodies,KPP':	'КПП',
'individualPersonForeignState,registerInRFTaxBodies,registrationDate':	'Дата_постановки_на_учет_в_налоговом_органе',
'individualPersonForeignState,placeOfStayInRegCountry,country':	'Страна_регистрации',
'individualPersonForeignState,placeOfStayInRegCountry,address':	'Адрес_места_нахождения_в_стране_регистрации',
'individualPersonForeignState,placeOfStayInRegCountry,postAddress':	'Почтовый_адрес_в_стране_регистрации',
'individualPersonForeignState,placeOfStayInRegCountry,contactEMail':	'Электронная_почта',
'individualPersonForeignState,placeOfStayInRegCountry,contactPhone':	'Телефон_в_стране_регистрации',
'individualPersonForeignState,placeOfStayInRF,OKTMO':	'ОКТМО',
'individualPersonForeignState,placeOfStayInRF,address':	'Адрес_места_нахождения',
'individualPersonForeignState,placeOfStayInRF,postAdressInfo,mailingAdress':	'Почтовый_адрес_пользователя',
'individualPersonForeignState,placeOfStayInRF,postAdressInfo,mailFacilityName':	'Наименование_объекта_почтовой_связи',
'individualPersonForeignState,placeOfStayInRF,postAdressInfo,postBoxNumber':	'Номер_ячейки_абонементного_почтового_шкафа',
'individualPersonForeignState,placeOfStayInRF,postAddressInfo,mailingAdress':	'Почтовый_адрес_пользователя',
'individualPersonForeignState,placeOfStayInRF,postAddressInfo,mailFacilityName':	'Наименование_объекта_почтовой_связи',
'individualPersonForeignState,placeOfStayInRF,postAddressInfo,postBoxNumber':	'Номер_ячейки_абонементного_почтового_шкафа',
'individualPersonForeignState,placeOfStayInRF,contactEMail':	'E_mail_адрес_контактного_лица',
'individualPersonForeignState,placeOfStayInRF,contactPhone':	'Телефон_контактного_лица',
'individualPersonForeignState,lastNameLat':	'Фамилия_латинскими_буквами',
'individualPersonForeignState,firstNameLat':	'Имя_латинскими_буквами',
'individualPersonForeignState,middleNameLat':	'Отчество_латинскими_буквами',
'individualPersonForeignState,registerInRFTaxBodies,status':	'Статус_поставщика',
'individualPersonForeignState,registerInRFTaxBodies,ERSMSPInclusionDate':	'Дата_включения_в_Единый_реестр',
'individualPersonForeignState,registerInRFTaxBodies,isIP':	'Индивидуальный_предприниматель',
'individualPersonForeignState,supplierAccountsDetails,supplierAccountDetails,personalAccountNumber':	'Реквизиты_счета_Личный_счет,',
'individualPersonForeignState,supplierAccountsDetails,supplierAccountDetails,creditOrgName':	'Реквизиты_счета_Наименование_кредитной_организации,',
'individualPersonForeignState,supplierAccountsDetails,supplierAccountDetails,bankAccountNumber':	'Реквизиты_счета_Номер_счета,',
'individualPersonForeignState,supplierAccountsDetails,supplierAccountDetails,bik':	'Реквизиты_счета_БИК_банка,',
'individualPersonForeignState,supplierAccountsDetails,supplierAccountDetails,corrAccountNumber':	'Реквизиты_счета_Корр_счет',
'individualPersonForeignStateisCulture,EGRULInfo,OGRN':	'ОГРН',
'individualPersonForeignStateisCulture,EGRULInfo,legalForm':	'Организационно_правовая_форма_организации',
'individualPersonForeignStateisCulture,EGRULInfo,fullName':	'Полное_наименование',
'individualPersonForeignStateisCulture,EGRULInfo,shortName':	'Сокращенное_наименование',
'individualPersonForeignStateisCulture,EGRULInfo,firmName':	'Фирменное_наименование',
'individualPersonForeignStateisCulture,EGRULInfo,INN':	'ИНН',
'individualPersonForeignStateisCulture,EGRULInfo,KPP':	'КПП',
'individualPersonForeignStateisCulture,EGRULInfo,registrationDate':	'Дата_постановки_на_учет_в_налоговом_органе',
'individualPersonForeignStateisCulture,EGRULInfo,address':	'Адрес_места_нахождения',
'individualPersonForeignStateisCulture,EGRULInfo,adress':	'Адрес_места_нахождения',
'individualPersonForeignStateisCulture,isSubdivision':	'Является_филиалом_юридического_лица_РФ',
'individualPersonForeignStateisCulture,otherInfo,status':	'Статус_поставщика',
'individualPersonForeignStateisCulture,otherInfo,ERSMSPInclusionDate':	'Дата_включения_в_Единый_реестр',
'individualPersonForeignStateisCulture,otherInfo,contractPrice':	'Размер_денежных_средств_благотворительность',
'individualPersonForeignStateisCulture,otherInfo,OKPO':	'ОКПО',
'individualPersonForeignStateisCulture,otherInfo,OKTMO':	'ОКТМО',
'individualPersonForeignStateisCulture,otherInfo,personalAccount':	'Номер_лицевого_счета',
'individualPersonForeignStateisCulture,otherInfo,postAdressInfo,mailingAdress':	'Почтовый_адрес_пользователя',
'individualPersonForeignStateisCulture,otherInfo,postAdressInfo,mailFacilityName':	'Наименование_объекта_почтовой_связи',
'individualPersonForeignStateisCulture,otherInfo,postAdressInfo,postBoxNumber':	'Номер_ячейки_абонементного_почтового_шкафа',
'individualPersonForeignStateisCulture,otherInfo,postAddressInfo,mailingAdress':	'Почтовый_адрес_пользователя',
'individualPersonForeignStateisCulture,otherInfo,postAddressInfo,mailFacilityName':	'Наименование_объекта_почтовой_связи',
'individualPersonForeignStateisCulture,otherInfo,postAddressInfo,postBoxNumber':	'Номер_ячейки_абонементного_почтового_шкафа',
'individualPersonForeignStateisCulture,contactInfo':	'Контактная_информация',
'individualPersonForeignStateisCulture,contactEMail':	'E_mail_адрес_контактного_лица',
'individualPersonForeignStateisCulture,contactPhone':	'Телефон_контактного_лица',
'individualPersonForeignStateisCulture,largestTaxpayerKPP':	'КПП_крупнейшего_налогоплательщика',
'individualPersonForeignStateisCulture,EGRIPInfo,OGRNIP':	'ОГРНИП',
'individualPersonForeignStateisCulture,EGRIPInfo,lastName':	'Фамилия',
'individualPersonForeignStateisCulture,EGRIPInfo,firstName':	'Имя',
'individualPersonForeignStateisCulture,EGRIPInfo,middleName':	'Отчество',
'individualPersonForeignStateisCulture,otherInfo,isIP':	'Индивидуальный_предприниматель',
'individualPersonForeignStateisCulture,lastName':	'Фамилия',
'individualPersonForeignStateisCulture,firstName':	'Имя',
'individualPersonForeignStateisCulture,middleName':	'Отчество',
'individualPersonForeignStateisCulture,INN':	'ИНН',
'individualPersonForeignStateisCulture,registrationDate':	'Дата_постановки_на_учет_в_налоговом_органе',
'individualPersonForeignStateisCulture,status':	'Статус_поставщика',
'individualPersonForeignStateisCulture,ERSMSPInclusionDate':	'Дата_включения_в_Единый_реестр',
'individualPersonForeignStateisCulture,OKTMO':	'ОКТМО',
'individualPersonForeignStateisCulture,personalAccount':	'Номер_лицевого_счета',
'individualPersonForeignStateisCulture,address':	'Адрес_места_нахождения',
'individualPersonForeignStateisCulture,postAddressInfo,mailingAdress':	'Почтовый_адрес_пользователя',
'individualPersonForeignStateisCulture,postAddressInfo,mailFacilityName':	'Наименование_объекта_почтовой_связи',
'individualPersonForeignStateisCulture,postAddressInfo,postBoxNumber':	'Номер_ячейки_абонементного_почтового_шкафа',
'individualPersonForeignStateisCulture,postAddress':	'Почтовый_адрес',
'individualPersonForeignStateisCulture,fullName':	'Полное_наименование',
'individualPersonForeignStateisCulture,shortName':	'Сокращенное_наименование',
'individualPersonForeignStateisCulture,firmName':	'Фирменное_наименование',
'individualPersonForeignStateisCulture,fullNameLat':	'Полное_наименование_латинскими_буквами',
'individualPersonForeignStateisCulture,taxPayerCode':	'Код_налогоплательщика_в_стране_регистрации',
'individualPersonForeignStateisCulture,registerInRFTaxBodies,INN':	'ИНН',
'individualPersonForeignStateisCulture,registerInRFTaxBodies,KPP':	'КПП',
'individualPersonForeignStateisCulture,registerInRFTaxBodies,registrationDate':	'Дата_постановки_на_учет_в_налоговом_органе',
'individualPersonForeignStateisCulture,placeOfStayInRegCountry,country':	'Страна_регистрации',
'individualPersonForeignStateisCulture,placeOfStayInRegCountry,address':	'Адрес_места_нахождения_в_стране_регистрации',
'individualPersonForeignStateisCulture,placeOfStayInRegCountry,postAddress':	'Почтовый_адрес_в_стране_регистрации',
'individualPersonForeignStateisCulture,placeOfStayInRegCountry,contactEMail':	'Электронная_почта',
'individualPersonForeignStateisCulture,placeOfStayInRegCountry,contactPhone':	'Телефон_в_стране_регистрации',
'individualPersonForeignStateisCulture,placeOfStayInRF,OKTMO':	'ОКТМО',
'individualPersonForeignStateisCulture,placeOfStayInRF,address':	'Адрес_места_нахождения',
'individualPersonForeignStateisCulture,placeOfStayInRF,postAdressInfo,mailingAdress':	'Почтовый_адрес_пользователя',
'individualPersonForeignStateisCulture,placeOfStayInRF,postAdressInfo,mailFacilityName':	'Наименование_объекта_почтовой_связи',
'individualPersonForeignStateisCulture,placeOfStayInRF,postAdressInfo,postBoxNumber':	'Номер_ячейки_абонементного_почтового_шкафа',
'individualPersonForeignStateisCulture,placeOfStayInRF,postAddressInfo,mailingAdress':	'Почтовый_адрес_пользователя',
'individualPersonForeignStateisCulture,placeOfStayInRF,postAddressInfo,mailFacilityName':	'Наименование_объекта_почтовой_связи',
'individualPersonForeignStateisCulture,placeOfStayInRF,postAddressInfo,postBoxNumber':	'Номер_ячейки_абонементного_почтового_шкафа',
'individualPersonForeignStateisCulture,placeOfStayInRF,contactEMail':	'E_mail_адрес_контактного_лица',
'individualPersonForeignStateisCulture,placeOfStayInRF,contactPhone':	'Телефон_контактного_лица',
'individualPersonForeignStateisCulture,lastNameLat':	'Фамилия_латинскими_буквами',
'individualPersonForeignStateisCulture,firstNameLat':	'Имя_латинскими_буквами',
'individualPersonForeignStateisCulture,middleNameLat':	'Отчество_латинскими_буквами',
'individualPersonForeignStateisCulture,registerInRFTaxBodies,status':	'Статус_поставщика',
'individualPersonForeignStateisCulture,registerInRFTaxBodies,ERSMSPInclusionDate':	'Дата_включения_в_Единый_реестр',
'individualPersonForeignStateisCulture,registerInRFTaxBodies,isIP':	'Индивидуальный_предприниматель',
'individualPersonForeignStateisCulture,supplierAccountsDetails,supplierAccountDetails,personalAccountNumber':	'Реквизиты_счета_Личный_счет,',
'individualPersonForeignStateisCulture,supplierAccountsDetails,supplierAccountDetails,creditOrgName':	'Реквизиты_счета_Наименование_кредитной_организации,',
'individualPersonForeignStateisCulture,supplierAccountsDetails,supplierAccountDetails,bankAccountNumber':	'Реквизиты_счета_Номер_счета,',
'individualPersonForeignStateisCulture,supplierAccountsDetails,supplierAccountDetails,bik':	'Реквизиты_счета_БИК_банка,',
'individualPersonForeignStateisCulture,supplierAccountsDetails,supplierAccountDetails,corrAccountNumber':	'Реквизиты_счета_Корр_счет',